アル	ある
オル	おる
オワル	終わる
カカル	かかる
ガエル	帰る、返る
ガカル	懸る
ガル	刈る
ガワル	代る、代わる
キル	きる、切る
ギシル	軋る
ギマル	決る
ギル	切る
グル	刳る、繰る
ゴモル	篭る、籠る
ザル	去る
ジマル	締まる
ズサル	退る
ズル	刷る、摺る、擦る
ゾル	剃る
タル	たる
ヅクル	作る、造る
ヅマル	詰まる、詰る
ヅル	吊る
トル	とる
ドル	どる、取る、捕る、撮る
ナル	なる
ハル	はる
バル	張る、貼る
ビタル	浸る
ブトル	太る、肥る
ブル	振る、降る
ベル	減る
ボソル	細る
ボル	彫る
マイル	まいる、参る
マクル	まくる
マワル	まわる、回る
ヤル	やる
