アジケ	あじけ、味け、味気
イタシカタ	いたし方、致し方、致方
オシミ	おしみ、惜しみ
オトナゲ	おとなげ、おとな気、大人げ、大人気
カギリ	かぎり、限り
ギコチ	ぎこち
ギゴチ	ぎごち
サリゲ	さりげ、さり気、然りげ
シカタ	しかた、仕方
ショーガ	しょうが、しようが
ソッケ	そっけ、素っ気
タアイ	たあい、他愛
タヨリ	たより、頼り
タワイ	たわい
ダラシ	だらし
チガイ	ちがい、違い
トンデモ	とんでも
マチガイ	まちがい、間違い
メンボク	めんぼく、面目
モンダイ	もんだい、問題
モーシワケ	もうしわけ、申しわけ、申し訳、申訳
