アイイク	あいいく、愛育
アイイン	あいいん、愛飲
アイガン	あいがん、哀がん、哀願、愛がん、愛玩
アイギン	あいぎん、愛吟
アイコ	あいこ、愛顧
アイコー	あいこう、愛好
アイゴ	あいご、愛護
アイサツ	あいさつ、挨拶
アイショウ	あいしょう
アイショー	愛しょう、愛唱、愛誦
アイジャク	あいじゃく
アイズ	あいず、アイズ、合図
アイセキ	あいせき、哀惜、愛惜
アイソ	あいそ、哀訴
アイゾー	あいぞう、愛蔵
アイタイ	あいたい、アイタイ、相対
アイチャク	あいちゃく、愛着
アイチョー	あいちょう、愛重
アイトー	あいとう、哀悼
アイドク	あいどく、愛読
アイドリング	アイドリング
アイハン	あいはん、相反
アイビキ	媾曳、逢引
アイブ	あいぶ、愛ぶ、愛撫
アイボ	あいぼ、愛慕
アイヨー	あいよう、愛用
アウフヘーベン	アウフヘーベン
アカンベエ	あかんべえ、アカンベエ
アキナイ	あきない、アキナイ、商い
アクシュ	あくしゅ、握手
アクジュンカン	あくじゅんかん、悪循環
アクセス	アクセス
アクセプト	アクセプト
アクセンクトー	あくせんくとう、悪戦苦闘
アクバ	あくば、悪ば、悪罵
アクビ	あくび、欠伸
アクメ	アクメ
アクヨー	あくよう、悪用
アシガタメ	足固め
アシドメ	足どめ、足止め、足留め
アジツケ	あじつけ、味つけ、味付、味付け
アジミ	あじみ、味見
アタイ	あたい、値、値い
アタック	アタック
アッカ	あっか、あっ化、悪化
アッサイ	あっさい、あっ砕、圧砕
アッサク	あっさく、あっ搾、圧搾
アッサツ	あっさつ、あっ殺、圧殺
アッシ	あっし、あっ死、圧死
アッシュク	あっしゅく、あっ縮、圧縮
アッショウ	あっしょう、あっ勝
アッショー	圧勝
アッセン	あっせん、あっ旋、斡旋
アッチャク	あっちゃく、圧着
アットウ	あっとう、あっ倒
アットー	圧倒
アッパク	あっぱく、圧迫
アッパーカット	アッパーカット
アッピール	アッピール
アップ	アップ
アップク	あっぷく、圧伏、圧服
アップリケ	アップリケ
アツエン	あつえん、圧延
アツギ	あつぎ、厚着
アツニュー	あつにゅう、圧入
アツメ	あつめ、集め
アテニゲ	あて逃げ、当て逃げ、当逃げ
アトオシ	あとおし、あと押し、後おし、後押、後押し
アトカタズケ	あとかたづけ、後かたづけ
アトシマツ	あとしまつ、あと始末、後しまつ、後始末
アトバライ	あと払い、後払、後払い
アトモドリ	あともどり、あと戻り、後もどり、後戻、後戻り
アドバイス	アドバイス
アドレス	アドレス
アドレッシング	アドレッシング
アナウメ	あなうめ、穴うめ、穴埋め
アナウンス	アナウンス
アニール	アニール
アバレ	あばれ、暴れ
アピール	アピール
アフ	阿付
アブラドーシ	油通し
アプローチ	アプローチ
アマモリ	あまもり、雨漏り
アメリカナイズ	アメリカナイズ
アユ	阿諛
アラカセギ	荒稼ぎ
アラゴナシ	あらごなし、粗ごなし、荒ごなし
アルバイト	アルバイト
アレンジ	アレンジ
アンガ	あんが、安が、安臥
アンキ	あんき、暗記、諳記
アンキョ	あんきょ、安居
アンギャ	あんぎゃ、行ぎゃ、行脚
アンコール	アンコール
アンゴー	あんごう、暗合
アンサツ	あんさつ、暗殺
アンザ	あんざ、安坐、安座
アンザン	あんざん、安ざん、安産、暗ざん、暗算
アンシュツ	あんしゅつ、案出
アンショー	あんしょう、暗しょう、暗唱、暗誦、諳誦
アンシン	あんしん、安心、安神
アンシンリツメイ	あんしんりつめい、安心立命
アンジ	あんじ、暗示
アンジュー	あんじゅう、安住
アンソク	安息
アンチ	安置
アンチャク	あんちゃく、安着
アンチューヒヤク	あんちゅうひやく、暗中飛躍
アンチューモサク	あんちゅうもさく、暗中模索
アンテン	あんてん、暗転
アントー	あんとう、暗闘
アンド	あんど、安ど、安堵
アンナイ	あんない、案内
アンバイ	あんばい、塩ばい、塩梅、按排、按配
アンブ	あんぶ、あん舞、按舞
アンブン	あんぶん、あん分、按分、案分
アンプ	あんぷ、暗ぷ、暗譜、諳譜
アンプク	あんぷく、按腹
アンポウ	あんぽう
アンポー	罨法
アンマ	あんま、あん摩、按摩
アンミン	あんみん、安眠
アンヤク	あんやく、暗躍
アース	アース
アービトレーション	アービトレーション
イアツ	いあつ、イアツ、威圧
イアン	いあん、慰安
イイワケ	いいわけ
イエデ	いえで、家出
イオンカ	イオン化
イカ	異化
イカク	いかく、威かく、威嚇
イカツ	いかつ、威喝
イカン	移管
イキ	委棄、息、遺棄
イキキ	いきき、行きき、行き来、行来
イキギレ	息ぎれ、息切れ
イキトーゴー	いきとうごう、意気投合
イキヌキ	いきぬき、イキヌキ、息ぬき、息抜き
イキョ	いきょ、依拠
イクエイ	いくえい、育英
イクシュ	いくしゅ、育種
イクジ	いくじ、育児
イクセイ	いくせい、育成
イクモー	いくもう、育毛
イケイ	いけい、い敬、畏敬
イケン	いけん、意見
イコー	移行、移項
イサカイ	いさかい、諍、諍い
イサン	移算
イシ	いし、い使、い死、縊死、頤使、頤指
イシキ	いしき、意識
イシツ	いしつ、遺失
イシャ	いしゃ、慰しゃ、慰藉、慰謝
イシュク	いしゅく、い縮、委縮、畏縮、萎縮
イシュツ	いしゅつ、移出
イシュー	いしゅう、い集、蝟集
イショク	いしょく、委嘱、移植
イジ	維持
イジイジ	いじいじ
イジュー	いじゅう、移住
イジョー	いじょう、囲繞、委譲、移乗、移譲
イセイ	いせい、遺精
イセキ	いせき、移籍
イセツ	いせつ、移設
イソー	いそう、移送
イゾン	いぞん、依存
イゾー	いぞう、遺贈
イタク	依託、委託
イタズラ	いたずら、イタズラ、悪戯
イタズリ	板ずり
イダツ	いだつ、遺脱
イチ	位置
イチギメ	位置決め
イチク	いちく、移築
イチゲキ	いちげき、一撃
イチゲン	一言
イチゲンカ	いちげんか、一元化
イチザ	いちざ、一座
イチジク	一軸
イチジュン	いちじゅん、一巡
イチダンラク	いちだんらく、一段落
イチトンザ	いちとんざ、一とんざ、一頓挫
イチドク	いちどく、一読
イチニン	いちにん、一任
イチネンホッキ	いちねんほっき、一念発起
イチバイ	いちばい、一倍
イチバンノリ	いちばんのり、一番乗り
イチベツ	いちべつ、一べつ、一瞥
イチボー	いちぼう、一ぼう、一望
イチモク	いちもく、一目
イチモンイットー	いちもんいっとう、一問一答
イチヤク	いちやく、一躍
イチュー	いちゅう、移駐
イチユー	いちゆう、一ゆう、一揖
イチョク	いちょく、違勅
イチョー	いちょう、移ちょう、移牒、移調
イチラン	いちらん、一覧
イチレイ	いちれい、一礼
イッ	逸
イッカツ	いっかつ、いっ喝、いっ括、一喝、一括
イッカツバライ	いっかつばらい、一括払い
イッカン	いっかん、いっ貫、一貫
イッキ	いっき、いっ機、逸機
イッキイチユー	いっきいちゆう、一喜一憂
イッキョー	いっきょう、一驚
イッケツ	いっけつ、いっ決、いっ血、一決、溢血
イッケン	いっけん、いっ見、一見
イッコ	いっこ、いっ顧、一顧
イッコー	いっこう、いっ考、一考
イッシュク	いっしゅく、いっ宿
イッシュツ	いっしゅつ、いっ出、逸出
イッシュー	いっしゅう、いっ周、一周、一蹴
イッショ	いっしょ、一緒
イッシン	いっしん、いっ新、一新
イッスイ	いっすい、いっ水、いっ睡、一睡、溢水
イッセン	いっせん、いっ戦、一戦、一閃
イッソー	いっそう、いっ掃、いっ走、一掃、逸走
イッタイカ	いったいか、一体化
イッチ	いっち、いっ致、一致
イッテイ	いってい、いっ定、一定
イッテキ	いってき、一擲
イッテン	いってん、いっ転、一転
イットー	いっとう、いっ統、一統
イッパイ	一ぱい、一敗
イッパク	いっぱく、一泊
イップク	いっぷく、一ぷく、一服
イッペン	いっぺん、一変
イッポンダチ	いっぽんだち、一本立ち
イッポー	一報
イツダツ	いつだつ、逸脱
イツユー	いつゆう、逸遊
イテン	いてん、移転
イデン	いでん、遺伝
イト	意図
イドー	いどう、異動、移動
イニュー	いにゅう、移入
イニョー	いにょう、囲にょう、囲繞、遺にょう、遺尿
イニン	いにん、委任
イヌジニ	犬死、犬死に
イネカリ	いねかり、稲刈り
イネムリ	いねむり、い眠り、イネムリ、居眠、居眠り
イノチビロイ	命びろい、命拾い
イハイ	いはい、違背
イハン	いはん、違反、違犯
イビ	いび、萎靡
イフ	いふ、い怖、畏怖
イフク	いふく、い服、威服、畏伏、畏服
イブ	いぶ、慰ぶ、慰撫
イミ	意味
イミン	いみん、移民
イメージ	イメージ
イモン	いもん、慰問
イヤク	いやく、意訳、違約
イヨー	いよう、移用
イライ	依頼
イリュー	いりゅう、慰留、遺留
イレイ	いれい、違令
イロズリ	色ずり、色刷、色刷り、色摺、色摺り
イロナオシ	いろなおし、色なおし、色直し
イロワケ	いろわけ、色わけ、色分け
イロー	いろう、慰労
イワイ	いわい、イワイ、祝い
イン	因、飲
インカ	いんか、いん可、允可、印加、印可、引火
インキョ	いんきょ、いん許、允許、隠居
インケツ	いんけつ、引決
インケン	いんけん、引見、隠見、隠顕
インコク	いんこく、印刻
インコー	いんこう、印行
インサツ	いんさつ、印刷
インシュ	いんしゅ、飲酒
インショク	いんしょく、飲食
インショー	いんしょう、引証
インジ	いんじ、印字、印磁
インセイ	いんせい、隠せい、隠栖、隠棲
インセキ	引責
インセツ	いんせつ、引接
インソツ	いんそつ、引率
インタイ	いんたい、引退、隠退
インタビュ	インタビュ
インタビュー	インタビュウ、インタビュー
インターセプト	インターセプト
インチ	いんち、引致
インチキ	いんちき
インデント	インデント
イントク	いんとく、隠匿
イントン	いんとん、隠とん、隠遁
インニン	いんにん、隠忍
インバイ	いんばい、淫売
インピ	いんぴ、隠ぴ、隠避
インプット	インプット
インペイ	いんぺい、陰蔽、隠ぺい、隠蔽
インメツ	いんめつ、いん滅、堙滅、湮滅
インユ	いんゆ、因由
インヨー	いんよう、引用、飲用
イーワケ	いいわけ、言い分け、言い訳、言分け、言訳
ウインク	ウインク
ウエジニ	飢え死、飢え死に、飢死、餓え死、餓え死に、餓死
ウエーブ	ウエーブ
ウォーミングアップ	ウォーミングアップ
ウオーサオー	うおうさおう、右往左往
ウオーミング	ウォーミング
ウオーミングアップ	ウオーミングアップ
ウカ	う化、羽化
ウカイ	うかい、う回、迂回
ウキシズミ	うきしずみ、浮き沈み
ウキョク	うきょく、う曲、紆曲、迂曲
ウケイ	うけい、右傾
ウケオイ	請け負い、請負
ウケコタエ	受けこたえ、受け答え、受答え
ウケツケ	うけつけ、ウケツケ、受けつけ、受け付、受け付け、受付、受付け
ウケワタシ	うけわたし、受けわたし、受け渡、受け渡し、受渡、受渡し
ウコサベン	うこさべん、右顧左べん、右顧左眄
ウスギ	うすぎ、うす着、薄着
ウスギリ	うす切り、薄切り
ウズウズ	うずうず
ウセツ	うせつ、右折
ウチアワセ	うちあわせ、打ちあわせ、打ち合せ、打ち合わせ、打合せ、打合わせ
ウチイワイ	内祝、内祝い
ウチジニ	うちじに、討ち死に、討死
ウチバリ	内張、内張り
ウチミズ	打ち水、打水
ウッキ	うっき、うっ気、ウッキ、鬱気
ウックツ	うっくつ、うっ屈、鬱屈
ウッケツ	うっけつ、うっ血、鬱結、鬱血
ウッセキ	うっせき、うっ積、鬱積
ウメアワセ	うめあわせ、埋めあわせ、埋め合せ、埋め合わせ
ウメタテ	うめたて、うめ立て、埋めたて、埋め立て、埋立
ウヨキョクセツ	う余曲折、紆余曲折
ウラウチ	うらうち、裏うち、裏打、裏打ち
ウラガキ	裏書
ウリオシミ	売り惜しみ
ウリカイ	売り買い
ウルウル	うるうる
ウレシナキ	うれしなき、うれし泣き、嬉し泣き、嬉泣き
ウロオボエ	うろ覚え
ウワガキ	うわがき、上がき、上書、上書き
ウワキ	うわき、うわ気、ウワキ、浮き、浮気
ウワサ	うわさ、ウワサ、噂
ウワスベリ	上滑り、上辷り
ウワズミ	上積、上積み
ウワヌリ	上塗、上塗り
ウワノセ	うわのせ、上のせ、上乗せ
ウンイ	うんい、うん為、云為
ウンエイ	うんえい、運営
ウンカイ	運開
ウンキュー	うんきゅう、運休
ウンコー	うんこう、運航、運行
ウンサン	うんさん、雲散
ウンサンムショー	うんさんむしょう、雲散霧消
ウンザン	うんざん、運ざん、運算
ウンシュー	うんしゅう、雲集
ウンシン	うんしん、運針
ウンジョー	うんじょう、うん醸
ウンソー	うんそう、運そう、運漕、運送
ウンテン	うんてん、運転
ウンドー	うんどう、運動
ウンヌン	うんぬん、云々、云云
ウンパン	うんぱん、運ぱん、運搬
ウンヨー	うんよう、運用
エイキョー	えいきょう、影響
エイギョー	えいぎょう、営業
エイケツ	えいけつ、永けつ、永訣
エイコー	えいこう、えい航、曳航
エイシャ	えいしゃ、映写
エイショー	えいしょう、詠唱
エイシン	えいしん、栄進、詠進
エイジュー	えいじゅう、永住
エイセイ	えいせい、永逝
エイゼン	えいぜん、営繕
エイソー	えいそう、営巣
エイゾク	えいぞく、永続
エイゾー	えいぞう、営造
エイタツ	えいたつ、栄達
エイタン	えいたん、詠嘆、詠歎
エイダツ	えいだつ、えい脱、穎脱
エイテン	えいてん、栄転
エイハツ	えいはつ、映発
エイベツ	えいべつ、永別
エイミン	えいみん、永眠
エイヤク	えいやく、英訳
エキ	益
エキカ	えきか、液化
エキサイト	エキサイト
エキサク	えきさく、易さく、易簀
エキム	役務
エコヒイキ	えこひいき、依怙贔屓
エコー	えこう、エコー、回向
エシ	壊死
エシャク	えしゃく、会釈
エスカレーション	エスカレーション
エスカレート	エスカレート
エスケープ	エスケープ
エスコート	エスコート
エッキョー	えっきょう、えっ境、越境
エッケン	えっけん、えっ見、謁見
エッソ	えっそ、えっ訴、越訴
エッチ	エッチ
エッチング	エッチング
エットー	えっとう、えっ冬、越冬
エップク	えっぷく、悦服
エッペイ	えっぺい、閲兵
エツドク	えつどく、閲読
エツネン	えつねん、越年
エツラク	えつらく、悦楽
エツラン	えつらん、閲覧
エトク	えとく、会得
エピタキシャルセイチョー	エピタキシャル成長
エラー	エラー
エンアク	えん悪
エンイン	えんいん、延引、援引
エンウンドー	えんうんどう、円運動
エンエイ	えんえい、遠泳
エンエキ	えんえき、演えき、演繹
エンカ	えんか、えん下、咽下、嚥下、塩化
エンキ	えんき、延期
エンギ	演技
エンギナオシ	えんぎなおし、縁起直し
エンゲン	えんげん、淵源
エンゲージ	エンゲージ
エンコ	えんこ
エンゴ	えんご、えん護、掩護、援護
エンサ	えんさ、怨嗟
エンザン	えんざん、演ざん、演算
エンシュツ	えんしゅつ、演出
エンシュー	えんしゅう、演習
エンショー	えんしょう、延焼
エンシン	えんしん、延伸
エンジュク	えんじゅく、円熟
エンジョ	えんじょ、援じょ、援助
エンジョイ	エンジョイ
エンジョー	えんじょう、炎上
エンスト	エンスト
エンセイ	えんせい、遠征
エンゼツ	えんぜつ、演ぜつ、演説
エンソー	えんそう、演奏
エンゾー	えんぞう、塩蔵
エンタイ	えんたい、延滞
エンチャク	えんちゃく、延着
エンチョー	えんちょう、延長
エントリー	エントリー
エンノー	えんのう、延納
エンパツ	えんぱつ、延ぱつ、延発
エンペイ	えんぺい、掩蔽
エンボー	えんぼう、遠望
エンメイ	えんめい、延命
エンメツ	えんめつ、煙滅
エンヨー	えんよう、援用
エンリョ	えんりょ、遠慮
オアイテ	おあいて、お相手、御相手
オイノリ	お祈り
オイワイ	お祝い、御祝い
オウケトリ	お受け取り、お受取、お受取り
オウト	おうと
オエカキ	おえかき、お絵書き
オエツ	おえつ、嗚咽
オオクリ	お送り
オオサメ	お納め
オカエシ	おかえし、お返し
オカケ	おかけ
オキザリ	置きざり、置き去り、置去り
オク	臆
オクソク	おくそく、おく測、憶測、臆測
オクダン	おくだん、おく断、臆断
オクリムカエ	送り迎え
オクリモノ	おくりもの、おくり物、オクリモノ、贈りもの、贈り物、贈物
オケイコ	お稽古
オコタエ	お答え
オコトワリ	お断り
オサソイ	お誘、お誘い、御誘、御誘い
オサン	お産、御産
オシウリ	おしうり、押し売り、押売、押売り
オシコミトリツケ	押込取付
オシッコ	おしっこ、オシッコ
オシモンドー	押し問答、押問答
オシャベリ	おしゃべり、お喋り
オシャレ	おしゃれ、お洒落、オシャレ
オシラセ	おしらせ、お知らせ
オジギ	おじぎ、お辞儀
オジャマ	おじゃま
オジョク	おじょく、汚辱
オススメ	おすすめ、お薦め、オススメ、御薦め
オセワ	おせわ、お世話、オセワ
オセン	おせん、汚染
オゼンダテ	おぜん立て、お膳立、お膳立て、御膳立、御膳立て
オソン	おそん、汚損
オタオタ	おたおた、オタオタ
オタズネ	お尋ね
オタヨリ	お便り
オダク	おだく、汚濁
オツタエ	お伝え
オテツダイ	おてつだい、お手つだい、お手伝い
オデカケ	お出かけ
オナニー	オナニー
オネガイ	おねがい、お願、お願い
オハナシ	おはなし、お話、お話し
オヒキウケ	お引き受、お引き受け、お引受、お引受け
オヒキタテ	お引き立、お引き立て、お引立、お引立て
オファー	オファー
オヘンジ	おへんじ、お返事、御返事
オペレーション	オペレーション
オボレジニ	溺れ死、溺れ死に
オマイリ	お参り、御参り
オマケ	おまけ
オマチ	おまち、お待、お待ち、オマチ
オマツリ	お祭、お祭り、御祭、御祭り
オミット	オミット
オミマイ	お見舞、御見舞、御見舞い
オメミエ	お目見え、お目見得、御目見え、御目見得
オモイチガイ	思いちがい、思い違い
オモテガキ	表書、表書き
オモミズケ	重みづけ、重み付け
オモラシ	おもらし
オモリ	おもり、お守、お守り、オモリ
オヤコーコー	おやこうこう、親孝行
オヤフコー	親不孝
オレイ	お礼、御礼
オロシウリ	おろしうり、おろし売り、卸し売り、卸売、卸売り
オワビ	おわび、お詫び
オン	オン
オンガエシ	おんがえし、恩がえし、恩返し
オンシャク	おんしゃく、恩借
オンゾン	温存
オンドク	おんどく、音読
オンブ	おんぶ
オンプク	おんぷく、温ぷく、温服
オンヤク	おんやく、音訳
オンヨク	おんよく、温浴
オンヨミ	おんよみ、おん読み、音読み
オーイツ	おういつ、横いつ、横溢
オーイン	おういん、押印
オーウツシ	大写し
オーエン	おうえん、応援
オーカ	おうか、おう歌、応化、押下、欧化、謳歌
オーカン	おうかん、往還
オーガ	おうが、枉が、枉駕、横が、横臥
オーコー	おうこう、横行
オーサツ	おうさつ、おう殺、殴殺、鏖殺
オーサワギ	おおさわぎ、おお騒ぎ、大さわぎ、大騒ぎ
オーシ	おうし、横死
オーシャ	おうしゃ、応射
オーシュー	おうしゅう、応酬、押収
オーショー	おうしょう、おう掌、応召、鞅掌
オーシン	おうしん、往診
オージュク	おうじゅく、黄熟
オージョー	おうじょう、往じょう、往生
オーセツ	おうせつ、応接
オーセン	おうせん、応戦
オーソ	おうそ、応訴
オーソライズ	オーソライズ
オーソン	大損
オーソー	おうそう、押送
オータイ	おうたい、応対
オーダ	殴打
オーダク	おうだく、応諾
オーダン	おうだん、横断
オーダー	オーダー
オーチャク	横着
オーテン	おうてん、横転
オート	おう吐、嘔吐
オートー	おうとう、応答
オーナツ	おうなつ、押なつ、押捺
オーノー	おうのう、おう悩、懊悩
オーバー	オーバー
オーバーラップ	オーバーラップ
オーバーラン	オーバーラン
オーフク	おうふく、往復
オーブリ	おおぶり、おお振り、大ぶり、大振り、大降り
オープン	オープン
オーホー	おうほう、往訪
オーボ	おうぼ、応募
オーモーケ	おおもうけ、大もうけ、大儲け
オーヤスウリ	大安売、大安売り
オーヨー	応用
オーライ	おうらい、往来
オーリョー	おうりょう、横領
オーワライ	おおわらい、大笑い
カ	嫁、架
カイ	介、解
カイアク	かいあく、改悪
カイイ	介意
カイイン	かいいん、改印、開院
カイエキ	かいえき、改易
カイエン	かいえん、開園、開宴、開演
カイオキ	買いおき、買い置き、買置き
カイカ	かいか、開化、開花
カイカイ	かいかい、開会
カイカク	かいかく、改革
カイカン	かいかん、開館
カイガン	かいがん、開眼
カイキ	かいき、回帰、快気
カイキョク	かいきょく、開局
カイキン	かいきん、皆勤、解禁
カイギ	かいぎ、会議、回議、懐疑
カイギョー	かいぎょう、改行、開業
カイク	かいく、化育
カイクン	かいくん、回訓
カイケイ	かいけい、会計
カイケツ	かいけつ、解決
カイケン	かいけん、会見
カイゲン	かいげん、改元、開眼
カイコ	かいこ、回顧、懐古、解雇
カイコク	かいこく、回国、廻国、戒告、開国
カイコン	かいこん、開墾
カイコー	かいこう、回航、改稿、邂逅、開校、開港
カイゴ	かいご、介護、悔悟、改悟
カイゴー	かいごう、会合、改号
カイサイ	かいさい、皆済、開催
カイサク	かいさく、改さく、改作、開さく、開削、開鑿
カイサツ	かいさつ、改札、開札
カイサン	かいさん、解散
カイザイ	かいざい、介在
カイザン	かいざん、改ざん、改竄
カイシ	かいし、怪死、開始
カイシメ	買い占め、買占め
カイシャ	かいしゃ、膾炙
カイシャク	かいしゃく、介しゃく、介錯、解しゃく、解釈
カイシュン	かいしゅん、悔しゅん、悔悛、改しゅん、改悛
カイシュー	かいしゅう、回収、改修、改宗
カイショ	開所
カイショク	かいしょく、会食、戒飭、海蝕、海食、解職
カイショー	かいしょう、会商、快しょう、快勝、改称、解消
カイシン	かいしん、回心、回申、回診、戒心、戒慎、改心、改新
カイジ	かいじ、開示
カイジセイギョ	かいじせいぎょ、界磁制御
カイジュー	かいじゅう、懐柔
カイジョ	かいじょ、解除
カイジョー	かいじょう、開城、開場
カイセイ	かいせい、回生、改姓、改正
カイセキ	かいせき、解析
カイセツ	かいせつ、回折、解説、開設
カイセン	かいせん、会戦、回旋、廻旋、改選、開戦
カイゼン	かいぜん、改善
カイソ	かいそ、改組
カイソー	かいそう、かい走、会葬、回そう、回想、回漕、回送、廻そう、廻漕、廻送、快走、改そう、改葬、改装、潰走
カイゾー	かいぞう、改造
カイタイ	かいたい、懐胎、拐帯、解体
カイタク	かいたく、開拓
カイダイ	かいだい、改題、解題
カイダク	かいだく、快諾
カイダメ	買いだめ
カイダン	かいだん、会談
カイチク	かいちく、改築
カイチュー	かいちゅう、懐中、改鋳
カイチョク	かいちょく、戒ちょく、戒飭
カイチョー	かいちょう、開帳
カイチン	かいちん、開陳
カイツケ	かいつけ、買いつけ、買い付け、買付け
カイツー	かいつう、開通
カイテイ	かいてい、改定、改訂、開廷
カイテン	かいてん、回転、廻転、開店
カイデン	かいでん、皆伝
カイトー	かいとう、回答、解凍、解答
カイドク	かいどく、会読、回読、解読
カイドー	かいどう、会同
カイニュー	かいにゅう、介入
カイニン	かいにん、懐妊、解任
カイハイ	かいはい、改廃
カイハツ	かいはつ、開発
カイハン	かいはん、改版、開板
カイヒ	かいひ、回避
カイヒョー	かいひょう、解ひょう、解氷、開票
カイフ	かいふ、回付、回附、廻附
カイフク	かいふく、回復、快復、恢復、開腹
カイフー	かいふう、開封
カイヘイ	かいへい、開平、開閉
カイヘン	かいへん、改変、改編
カイホー	かいほう、介抱、懐抱、解放、開放
カイボー	かいぼう、解剖
カイマク	かいまく、開幕
カイミン	かいみん、快眠
カイメイ	かいめい、改名、解明
カイメツ	かいめつ、かい滅、壊滅、潰滅
カイモノ	買いもの、買い物、買物
カイモン	かいもん、開門
カイヤク	かいやく、改訳、解約
カイユ	かいゆ、快癒
カイユー	かいゆう、回遊
カイラン	かいらん、かい乱、回らん、回覧、壊乱、廻らん、廻覧、潰乱、解らん、解纜
カイリ	かいり、かい離、乖離、解離
カイリュー	かいりゅう、開立
カイリョー	かいりょう、改良
カイレイ	かいれい、回礼
カイワ	かいわ、会話
カウント	カウント
カエリザキ	返り咲き、返咲き
カオアワセ	かおあわせ、顔あわせ、顔合せ、顔合わせ
カカイ	かかい、加階
カカン	かかん、下かん、下瞰、加かん、加冠
カキオキ	かきおき、書きおき、書置
カキカエ	かきかえ、書き換え、書き替え、書換え、書替え
カキュー	かきゅう、加給
カキョ	かきょ、家居
カキョー	かきょう、架橋
カキン	かきん、課金
カクアゲ	かくあげ、格あげ、格上げ
カクゲン	かくげん、確言
カクゴ	かくご、覚悟
カクサク	かくさく、画策
カクサゲ	かくさげ、格さげ、格下げ
カクサン	かくさん、拡散
カクザ	かくざ、かく座、擱坐、擱座
カクシ	かくし、客死
カクシツ	かくしつ、確執
カクシュ	かくしゅ、かく首、馘首、鶴首
カクショー	かくしょう、確証
カクシン	かくしん、確信、革新
カクジツシ	かくじつし、確実視
カクジュー	かくじゅう、拡充
カクズケ	かくづけ、格づけ、格付、格付け
カクセイ	かくせい、かく清、廓清、拡声、覚せい、覚醒
カクゼツ	かくぜつ、隔絶
カクダイ	かくだい、廓大、拡大
カクチク	かくちく、角逐
カクチョー	かくちょう、拡張
カクテイ	かくてい、劃定、画定、確定
カクトク	かくとく、獲得
カクトー	かくとう、挌闘、格闘、確答
カクド	かくど、かく怒、嚇怒、赫怒
カクニン	かくにん、確認
カクノー	かくのう、格納
カクハン	かくはん、撹拌
カクヒツ	かくひつ、かく筆、擱筆
カクブン	かくぶん、確聞
カクブンレツ	かくぶんれつ、核分裂
カクヘンカン	かくへんかん、核変換
カクホ	かくほ、確保
カクヤク	かくやく、確約
カクラン	かくらん、かく乱、撹乱、攪乱
カクリ	かくり、隔り、隔離
カクリツ	かくりつ、確立
カクレンボ	かくれんぼ
カケアシ	かけあし、かけ足、駆け足、駆足
カケオチ	かけおち、かけ落ち、駆け落ち、駆落ち
カケザン	かけ算、掛け算、掛算
カケツ	かけつ、可決
カケヒキ	かけひき、かけ引き、駆け引き、駆引き
カケモチ	かけ持ち、掛け持ち、掛持ち
カゲボシ	かげぼし、陰乾し、陰干し
カゲン	かげん、加減
カゲンジョージョ	かげんじょうじょ、加減乗除
カコー	下降、加工
カゴ	加護
カゴー	かごう、化合
カサク	かさく、仮作
カサン	かさん、加さん、加算、加餐
カシ	下賜
カシツ	かしつ、加湿
カシャク	かしゃく、仮借
カショク	かしょく、仮植、火食、過食
カショー	かしょう、仮称、嘉賞、歌唱、火傷、過称、過賞
カシン	かしん、過信
カジ	加持
カジュー	かじゅう、加重
カジョ	かじょ、加除
カジョー	かじょう、火定
カジョーガキ	かじょうがき、箇条書、箇条書き
カスイ	かすい、下垂、仮睡
カセイ	かせい、加勢、化成、化生
カセキ	かせき、カセキ、化石
カセツ	かせつ、仮設、架設
カセン	かせん、寡占
カゼイ	かぜい、課税
カソク	かそく、加速
カソー	かそう、仮想、仮葬、仮装、火葬
カゾー	かぞう、加増、家蔵、架蔵
カタイレ	肩入、肩入れ
カタオモイ	かたおもい、片思い
カタガワリ	肩がわり、肩代り、肩代わり
カタク	かたく、仮託
カタクズレ	かたくずれ、型くずれ
カタツ	かたつ、下達
カタン	かたん、加担、荷担
カチコシ	勝ち越し、勝越、勝越し
カチマケ	勝負
カチュー	かちゅう、火中
カッカ	かっか
カッカン	かっかん、かっ観
カッキョ	かっきょ、かっ拠、割拠
カックー	かっくう、かっ空、滑空
カッケツ	かっけつ、かっ血、喀血
カッコ	かっこ、かっ孤、括弧
カッコー	かっこう、かっ降、滑降
カッサイ	かっさい、喝さい、喝采
カッシャ	かっしゃ、かっ写、活写
カッショー	かっしょう、滑翔
カッスイ	かっすい、かっ水、渇水
カッセン	かっせん、合戦
カッソー	かっそう、かっ走、滑走
カッチャク	かっちゃく、かっ着、活着
カッティング	カッティング
カット	カット
カットオフ	カットオフ
カッパ	かっぱ、喝破
カップ	かっぷ、割賦
カップク	かっぷく、割腹
カッポ	かっぽ、かっ歩、カッ歩、闊歩
カツアイ	かつあい、割愛
カツゴー	かつごう、渇ごう、渇仰
カツジョー	かつじょう、割譲
カツドー	かつどう、活動
カツボー	かつぼう、渇望
カツモク	かつもく、かつ目、カツモク、刮目
カツヤク	かつやく、活躍
カツヨー	かつよう、活用
カテイ	かてい、仮定
カテン	かてん、加点
カデン	かでん、荷電、訛伝
カトー	かとう、加糖
カドデ	かどで、門出
カドー	か働、稼働、稼動
カニュー	かにゅう、加入
カネツ	かねつ、加熱、過熱
カネモーケ	かねもうけ、カネもうけ、金もうけ、金儲け
カノー	かのう、か納、化のう、化膿、嘉納
カハイ	かはい、加配
カバー	カバー
カヒツ	かひつ、加筆
カフ	かふ、下付
カブ	歌舞
カホー	かほう、下放
カミ	加味
カミン	かみん、仮眠、夏眠
カムバック	カムバック
カムフラージュ	カムフラージュ
カメイ	かめい、下命、加盟
カモン	かもん、下問
カラタケワリ	からたけわり、幹竹わり、幹竹割、幹竹割り
カラトリヒキ	から取引、空取引
カラブリ	からぶり、から振、から振り、カラブリ、カラ振り、空ぶり、空振、空振り
カラマワリ	からまわり、から回り、カラ回り、空まわり、空回り
カリイレ	借入、借入れ
カリシャクホー	かりしゃくほう、仮釈放
カリショブン	かりしょぶん、仮処分
カリズマイ	かりずまい、仮住い、仮住まい
カリチョーイン	かりちょういん、仮調印
カリヌイ	かりぬい、仮縫い
カリョー	かりょう、加療
カン	姦、関
カンアン	かんあん、勘案
カンイン	かんいん、姦淫
カンオン	かんおん、感恩
カンオー	かんおう、感応
カンカ	かんか、感化、換価、看過
カンカイ	かんかい、勧戒、緩解
カンカク	かんかく、かん格、扞格
カンカツ	かんかつ、管轄
カンガイ	かんがい、潅漑
カンキ	かんき、喚起、換気、歓喜
カンキャク	かんきゃく、閑却
カンキュー	かんきゅう、官給、感泣
カンキョ	かんきょ、官許、閑居
カンキン	かんきん、換金、監禁
カンギョ	かんぎょ、還御
カンギン	かんぎん、感吟、閑吟
カンケイ	かんけい、還啓、関係
カンケツ	かんけつ、完結
カンゲ	かんげ、勧げ、勧化
カンゲイ	かんげい、歓迎
カンゲキ	かんげき、カンゲキ、感激、観劇
カンゲン	かんげん、かん言、換言、諌言、還元
カンコ	かんこ、歓呼
カンコク	かんこく、勧告
カンコツダッタイ	かんこつだったい、換骨奪胎
カンコー	かんこう、かん口、刊行、勘校、勘考、完工、感光、敢行、箝口、緘口、緩行、観光、還幸
カンゴ	かんご、監護、看護、閑語
カンゴー	かんごう、勘合
カンサ	かんさ、監査、鑑査
カンサイ	かんさい、完済
カンサク	かんさく、間作
カンサツ	かんさつ、監察、観察
カンサン	かんさん、換算
カンシ	かんし、かん止、かん死、監視、諌止、諌死
カンシャ	かんしゃ、感しゃ、感謝
カンシュ	かんしゅ、看取
カンシュー	かんしゅう、監修
カンショク	かんしょく、間食
カンショー	かんしょう、勧奨、勧賞、完勝、干渉、感賞、管掌、緩衝、観照、観賞、鑑賞
カンシン	かんしん、感心
カンジ	かんじ、換字
カンジュ	かんじゅ、感受、甘受
カンジュク	かんじゅく、完熟、慣熟
カンジョ	かんじょ、寛恕
カンジョー	かんじょう、かん定、勘定、勧じょう、勧請
カンジン	かんじん、勧じん、勧進
カンスイ	かんすい、かん水、冠水、完遂、潅水
カンセイ	かんせい、完成、管制
カンセン	かんせん、感染、観戦
カンゼツ	かんぜつ、冠絶
カンソク	かんそく、観測
カンソー	かんそう、乾燥、完走、歓送、還送
カンタイ	かんたい、款待、歓待
カンタク	かんたく、干拓
カンタン	かんたん、カンタン、感嘆、感歎
カンダン	かんだん、歓談、閑談
カンチ	かんち、感知、換地、関知
カンチガイ	かんちがい、勘ちがい、勘違い
カンチョー	かんちょう、かん腸、浣腸、潅腸、灌腸
カンツー	かんつう、かん通、姦通、貫通
カンテイ	かんてい、戡定、鑑定
カンテツ	かんてつ、貫徹
カンデン	かんでん、感電
カントク	かんとく、カントク、感得、監督
カントー	かんとう、完投、敢闘
カンドー	かんどう、勘どう、勘当、感どう、感動
カンニュー	かんにゅう、かん入、嵌入
カンニン	かんにん、堪忍
カンニング	カンニング
カンネン	かんねん、観念
カンノー	かんのう、完納、感応
カンバイ	かんばい、完売
カンバツ	かんばつ、簡抜、間伐
カンパ	かんぱ、カンパ、看ぱ、看破
カンパイ	かんぱい、カンパイ、乾ぱい、乾杯、完ぱい、完敗、感ぱい、感佩
カンパツ	かんぱつ、かん発、渙発、煥発
カンパン	かんぱん、干ぱん、干犯
カンビ	かんび、完備
カンビョー	かんびょう、看病
カンブツ	かんぶつ、換物
カンプ	かんぷ、カンプ、還ぷ、還付
カンプク	かんぷく、感ぷく、感服
カンプン	かんぷん、感ぷん、感奮
カンプー	かんぷう、完ぷう、完封
カンベツ	かんべつ、鑑別
カンベン	かんべん、勘弁
カンボツ	かんぼつ、陥没
カンボー	かんぼう、観望
カンポ	完歩
カンメイ	かんめい、感銘、肝銘
カンモク	かんもく、かん黙、緘黙
カンモン	かんもん、喚問
カンヤク	かんやく、完訳、監訳、簡約
カンユー	かんゆう、勧誘
カンヨ	かんよ、干与、関与
カンヨー	かんよう、かん養、慣用、涵養
カンラク	かんらく、陥落
カンラン	かんらん、観覧
カンリ	かんり、監理、管理
カンリャク	かんりゃく、簡略
カンリュー	かんりゅう、乾溜、乾留、貫流、還流
カンリョー	かんりょう、完了
カンレン	かんれん、関聯、関連
カンワ	かんわ、緩和
カーブ	カーブ
カール	カール
ガイ	概
ガイカツ	がいかつ、概括
ガイカン	がいかん、概観
ガイサン	がいさん、概算
ガイザイ	がいざい、外在
ガイシュツ	がいしゅつ、外出
ガイショク	がいしょく、外食
ガイセイ	がいせい、外征
ガイセツ	がいせつ、外切、外接、概説
ガイセン	がいせん、がい旋、凱旋
ガイソー	がいそう、咳嗽、外そう
ガイタン	がいたん、慨嘆、慨歎
ガイチュー	がいちゅう、外注
ガイチョウ	開帳
ガイトー	がいとう、該当
ガイド	ガイド
ガイハク	がいはく、外泊
ガイヒョー	がいひょう、概評
ガイユー	がいゆう、外遊
ガイロン	がいろん、概論
ガカイ	がかい、が解、瓦解
ガクシュー	がくしゅう、学修、学習
ガクモン	がくもん、学問
ガシ	餓死
ガショー	がしょう、が床、臥床
ガタオチ	がた落ち、ガタ落ち
ガッサク	合作
ガッサツ	合冊
ガッサン	がっさん、合さん、合算
ガッシュク	がっしゅく、ガッシュク、合宿
ガッショー	がっしょう、合唱、合掌
ガッセン	合戦
ガッソー	がっそう、合そう、合奏
ガッタイ	がったい、ガッタイ、合体
ガッチ	がっち、合致
ガッテン	がってん、ガッテン、合点
ガッピョー	がっぴょう、合ぴょう、合評
ガッペイ	がっぺい、合ぺい、合併
ガッポン	がっぽん、合ぽん、合本
ガッポー	合邦
ガテン	がてん、合点
ガブノミ	がぶ飲み、ガブ飲み
ガマン	がまん、ガマン、我慢
ガンイ	がんい、含意
ガンコー	がんこう、がん行、雁行
ガンサク	がんさく、がん作、贋作
ガンシン	がんしん、含浸
ガンソー	がんそう、含そう、含嗽
ガンゾー	がんぞう、がん造、贋造
ガンチク	がんちく、含蓄
ガンボー	がんぼう、願望
ガンミ	がんみ、がん味、含味、玩味
ガンユー	がんゆう、含有
ガンロー	がんろう、玩弄
ガード	ガード
キ	帰、記
キアン	きあん、き案、キアン、起案
キイツ	きいつ、き一、キ一、帰一
キイン	きいん、キイン、起因
キエ	き依、帰え、帰依
キエイ	きえい、き営、帰営
キエツ	喜悦
キオク	きおく、キオク、記おく、記憶
キオチ	き落、き落ち、気落、気落ち
キカ	きか、帰化、気化
キカク	きかく、き画、キカク、企劃、企画
キカン	きかん、き館、キカン、帰艦、帰還、帰館、饋還
キガ	きが、帰が、帰臥、起が、起臥
キガエ	着替え
キガネ	きがね、気がね、気兼ね
キガン	きがん、祈願
キキャク	ききゃく、棄却
キキュー	ききゅう、企及、冀求、希求、帰休
キキョ	ききょ、き居、起居
キキョー	ききょう、帰京、帰郷
キキン	ききん、寄金
キギ	きぎ、き戯、嬉戯
キギョー	きぎょう、起業
キク	危く、危懼、掬
キクバリ	きくばり、気くばり、気配り
キグ	きぐ、キグ、危ぐ、危惧
キグロー	き苦労、気苦労
キグー	きぐう、奇ぐう、寄寓
キケツ	きけつ、帰結
キケン	きけん、棄権
キコク	きこく、き国、キコク、キ国、帰国
キコー	きこう、寄港、寄稿、帰港、帰耕、起工、起稿、騎行
キゴー	きごう、揮ごう、揮毫
キサイ	きさい、記載、起債
キサン	きさん、き参、き山、き算、キサン、キ山、帰さん、帰参、帰山、起さん、起算
キザ	跪坐
キシ	きし、き死、愧死
キシャ	きしゃ、き捨、き社、キシャ、喜捨、帰社、騎射
キシャク	きしゃく、希釈、稀釈
キシュク	寄宿
キシュツ	きしゅつ、き出、キシュツ、キ出、既出
キシュー	きしゅう、奇襲
キショ	きしょ、寄書
キショク	きしょく、き食、キショク、寄食
キショー	きしょう、き傷、毀しょう、毀傷、起しょう、起床、起請
キシン	きしん、寄進
キジュツ	きじゅつ、記述
キジュン	きじゅん、帰順
キジョー	きじょう、き乗、キジョウ、騎乗
キジン	きじん、帰陣
キス	キス
キスー	きすう、帰すう、帰趨
キズカレ	き疲、き疲れ、気づかれ、気疲れ
キセイ	きせい、寄生、帰省、祈誓、規制、規整、規正
キゼツ	きぜつ、き絶、キゼツ、気絶
キソ	きそ、起訴
キソン	きそん、き損、既存、毀損
キソー	起草
キゾク	きぞく、キゾク、キ属、帰属
キゾー	きぞう、寄贈
キタイ	きたい、き待、キタイ、期待
キタク	きたく、寄託、帰宅
キタマワリ	北回り
キチ	きち、き知、窺知
キチャク	き着、帰着
キチョー	きちょう、帰朝、記帳
キッキョー	きっきょう、きっ驚、喫驚
キック	キック
キッコー	きっこう、きっ抗、拮抗
キッス	キッス
キッセキ	詰責
キツエン	きつえん、喫煙
キツケ	きつけ、き付、き付け、キ付、着つけ、着付、着付け
キツモン	詰問
キツリツ	きつりつ、きつ立、屹立
キテイ	きてい、規定、規程
キト	きと、企図
キトー	きとう、帰投、祈とう、祈祷
キドー	きどう、起動
キニュー	きにゅう、き入、キニュウ、キ入、記入
キニン	きにん、き任、キニン、帰任
キネン	きねん、き念、キネン、祈念、記念
キノリ	きのり、キノリ、気のり、気乗り
キノー	帰納、帰農、機能
キハイ	きはい、き拝、跪拝
キハツ	きはつ、揮発
キバラシ	きばらし、気ばらし、気晴、気晴し、気晴らし
キヒ	きひ、忌避
キヒツ	き筆、起筆
キフ	きふ、寄付、寄附
キフク	きふく、き伏、き服、帰伏、帰服、起伏
キボー	きぼう、希望
キメイ	き名、キ名、記名
キャクショク	脚色
キャッカ	きゃっか、きゃっ下、却か、却下
キャッカン	客観
キャッチ	キャッチ
キャンセル	キャンセル
キャンプ	キャンプ
キュー	仇、窮、給
キューアイ	きゅうあい、求愛
キューイン	きゅういん、吸引
キューエン	きゅうえん、休演、救えん、救援
キューカイ	きゅうかい、休会
キューカン	きゅうかん、休刊、休館
キューガク	休学
キューキ	きゅうき、吸気
キューギョー	休業
キューケイ	きゅうけい、休けい、休憩、求刑
キューケツ	きゅうけつ、給血
キューゲン	きゅうげん、急減
キューコク	急告
キューコン	きゅうこん、求婚
キューコー	きゅうこう、きゅう行、休校、休耕、休航、休講、急こう、急行、躬行
キューコーカ	急降下
キューゴ	きゅうご、救護
キューゴー	きゅうごう、きゅう合、糾合、鳩合
キューサイ	きゅうさい、休載、救済
キューシ	きゅうし、休止、急死、窮し、窮死
キューシュ	きゅうしゅ、きゅう首、鳩首
キューシュツ	きゅうしゅつ、救出
キューシュー	きゅうしゅう、吸収、急襲
キューショク	きゅうしょく、きゅう食、休職、求職、給食
キューシン	きゅうしん、休心、休神、休診、急進
キュージ	給仕
キュージュツ	きゅうじゅつ、救じゅつ、救恤
キュージョ	きゅうじょ、救じょ、救助
キュージョー	きゅうじょう、休場
キュージョーショー	急上昇
キュージン	きゅうじん、求人
キュースイ	きゅうすい、給水
キューセイ	きゅうせい、急逝
キューセツ	きゅうせつ、急設
キューセン	きゅうせん、休戦
キューソ	きゅうそ、泣そ、泣訴
キューソク	きゅうそく、休息
キューソー	きゅうそう、急そう、急送
キューゾー	きゅうぞう、急増、急造
キューダイ	きゅうだい、及第
キューダン	きゅうだん、きゅう弾、糺弾、糾弾
キューチャク	吸着
キューツイ	急追、窮追
キューテイ	きゅうてい、休廷
キューテイシャ	急停車
キューテン	きゅうてん、急転
キューテンチョッカ	急転直下
キューデン	きゅうでん、休電、給電
キュートー	きゅうとう、急騰
キューニュー	吸入
キューハ	きゅうは、急は、急派
キューハイ	きゅうはい、九拝、朽廃
キューハイギョー	休廃業
キューハク	きゅうはく、急迫、窮迫
キューヒ	きゅうひ、給費
キューフ	きゅうふ、給ふ、給付
キューブ	きゅうぶ、休部
キューヘン	急変
キューホー	きゅうほう、急報
キューボ	きゅうぼ、急募
キューボー	きゅうぼう、窮乏
キューミン	きゅうみん、休眠
キューメイ	きゅうめい、きゅう明、救命、究明、窮命、糺明、糾明
キューモン	きゅうもん、きゅう問、糺問、糾問
キューユ	きゅうゆ、給油
キューヨ	きゅうよ、給与
キューヨー	きゅうよう、休養、給養
キューラク	急落
キューレイ	きゅうれい、急冷
キョカ	きょか、許か、許可
キョキ	きょき、歔欷
キョキン	きょきん、きょ金、醵金
キョク	きょく、局
キョクゲン	局限、曲げん、曲言、極言
キョクザイ	局在
キョクセキ	きょくせき、跼蹐
キョクセツ	曲折
キョクドメ	局止、局止め
キョクロン	極論
キョコクイッチ	挙国一致
キョコー	挙行、虚構
キョザ	きょざ、踞座
キョシ	きょし、拒止、挙し、挙止
キョシキ	挙式
キョシュ	挙手
キョシュツ	きょしゅつ、きょ出、拠出、醵出
キョショー	きょしょう、挙証
キョジュー	居住
キョセイ	きょせい、去勢
キョゼツ	拒絶
キョダク	許諾
キョダツ	虚脱
キョッカイ	曲かい、曲解
キョッカン	きょっかん、極諌
キョヒ	きょひ、拒否
キョヘイ	きょへい、挙兵
キョヨー	挙用、許容
キョライ	去来
キョリュー	居留
キョー	供、狂、饗
キョーアツ	強圧
キョーイク	きょういく、きょう育、教育
キョーエイ	きょうえい、共栄、競映、競泳
キョーエツ	恐悦、恭悦
キョーエン	きょうえん、共演、協演、競演
キョーオー	きょうおう、供応、饗応
キョーカ	きょうか、強か、強化、教か、教化
キョーカイ	きょうかい、教戒、教誡、教誨
キョーカツ	きょうかつ、恐喝
キョーカン	きょうかん、共感
キョーガク	きょうがく、驚がく、驚愕
キョーキ	きょうき、共起、狂喜、驚き、驚喜
キョーキュー	きょうきゅう、供給
キョーギ	きょうぎ、協議、競技
キョーギョー	きょうぎょう、協業
キョーク	きょうく、恐く、恐懼
キョークン	きょうくん、教くん、教訓
キョーケツ	供血
キョーゲキ	きょうげき、きょう撃、夾撃、挟撃
キョーコー	強攻、強行
キョーゴ	きょうご、教ご、教護
キョーゴウ	きょうごう
キョーゴー	校合、競合
キョーサ	きょうさ、教さ、教唆
キョーサイ	きょうさい、共催
キョーサク	きょうさく、競作
キョーサツ	きょうさつ
キョーサン	きょうさん、協さん、協賛
キョーシ	教し、教示、狂し、狂死
キョーシュ	きょうしゅ、拱手
キョーシュク	恐縮
キョーシュツ	供出
キョーシュー	きょうしゅう、強襲、教習
キョーショー	きょうしょう、協商
キョーシン	きょうしん、共振、強振、狂信
キョージ	きょうじ、教示
キョージュ	きょうじゅ、享受
キョージュツ	供述
キョーセイ	きょうせい、きょう正、共棲、共生、匡正、強せい、強制、強請、矯正
キョーソン	共存
キョーソー	きょうそう、競そう、競争、競走
キョーゾン	きょうぞん、共存
キョータク	きょうたく、供託
キョータン	きょうたん、驚嘆、驚歎
キョーダ	きょうだ、強だ、強打
キョーチョク	強直
キョーチョー	きょうちょう、協調、強調
キョーツー	きょうつう、共通
キョーテイ	きょうてい、キョウテイ、協定
キョートー	きょうとう、共闘、驚倒
キョードー	きょうどう、きょう導、共どう、共同、協同、嚮導、教どう、教導
キョーハク	きょうはく、強迫、脅迫
キョーバイ	きょうばい、競売
キョーフ	きょうふ、恐怖
キョーベン	きょうべん、強べん、強弁
キョーホン	狂奔
キョーボー	きょうぼう、共謀
キョーメイ	きょうめい、共鳴
キョーヤク	きょうやく、協約
キョーユー	きょうゆう、享有、共有
キョーヨ	きょうよ、供よ、供与
キョーヨー	きょうよう、供用、共用、強要
キョーラク	きょうらく、享楽、競落
キョーラン	きょうらん、供覧、狂乱
キョーリツ	きょうりつ、共立
キョーリョク	きょうりょく、きょう力、協力
キョーレン	教練
キョーワ	きょうわ、協和
キヨ	きよ、寄与
キヨー	きよう、起用
キライ	帰来
キラク	きらく、帰らく、帰洛
キリアゲ	きりあげ、切りあげ、切り上げ、切上げ
キリサゲ	切り下げ、切下げ
キリジニ	切死、斬り死に、斬死
キリステ	きりすて、切りすて、切り捨て、切捨、切捨て
キリツ	きりつ、き立、キリツ、起立
キリトリ	きりとり、キリトリ、切りとり、切り取り、切取り
キリハリ	きりはり、切りはり、切り貼り
キリモリ	きりもり、キリモリ、切りもり、切り盛り、切盛り
キリュー	きりゅう、寄留
キレツ	きれつ、き裂、キレツ、龜裂
キロク	きろく、き録、キロク、記ろく、記録
キヲイツニ	軌を一に
キンアツ	禁圧
キンエン	きんえん、禁烟、禁煙
キンガク	きんがく、勤学
キンキ	きんき、欣喜、禁忌
キンキジャクヤク	きんきじゃくやく、欣喜雀躍
キンコ	きんこ、禁固、禁錮
キンコク	きんこく、謹告
キンコー	きんこう、均衡
キンサク	きんさく、金策
キンシ	きんし、キンシ、禁し、禁止
キンシュ	禁酒
キンシュク	緊縮
キンショ	謹書
キンシン	きんしん、謹慎
キンジ	きんじ、近似、近侍
キンセイ	きんせい、禁制、謹製
キンセツ	近接
キンセン	きんせん、謹せん、謹撰、謹選
キンゼツ	禁絶
キンソク	禁足
キンゾク	きんぞく、勤続
キンダン	きんだん、禁断
キンチャク	きんちゃく、キンチャク、近着
キンチョー	きんちょう、緊ちょう、緊張、謹ちょう、謹聴、金ちょう、金打
キンテイ	きんてい、謹呈
キンテン	きんてん、均てん、均霑
キンノー	きんのう、金のう、金納
キンバク	きんばく、きん縛、緊縛
キンバン	勤番
キンパク	きんぱく、緊ぱく、緊迫
キンブン	きんぶん、均分
キンボ	きんぼ、欽慕
キンム	きんむ、勤む、勤務
キンヨク	禁欲
キンロー	きんろう、勤労
キンワ	きんわ、謹話
キープ	キープ
ギク	疑く、疑懼
ギケツ	議決
ギサク	ぎ作、偽作
ギショー	ぎしょう、偽称、偽証
ギジョー	議定
ギゼツ	義絶
ギソー	ぎそう、ぎ装、偽装、擬装、艤装
ギゾー	ぎぞう、偽造
ギテイ	議定
ギフト	ギフト
ギマン	ぎまん、ギマン、欺まん、欺瞞
ギャクサツ	ぎゃくさつ、虐殺
ギャクサン	ぎゃくさん、逆算
ギャクシ	虐使
ギャクシュー	ぎゃくしゅう、逆襲
ギャクジョー	逆上
ギャクタイ	ぎゃくたい、虐待
ギャクテン	ぎゃくてん、ギャクテン、逆転
ギャクト	ぎゃくと、逆と、逆睹
ギャクモドリ	逆もどり、逆戻、逆戻り
ギャクヨー	逆用
ギャクリュー	逆流
ギャッコー	ぎゃっこう、ぎゃっ行、逆行
ギューインバショク	牛飲馬食
ギョカク	漁獲
ギョクサイ	玉砕
ギョーガ	ぎょうが、仰が、仰臥
ギョーギ	ぎょうぎ、凝議
ギョーケツ	凝結、凝血
ギョーコ	ぎょうこ、凝こ、凝固
ギョーコー	ぎょうこう、行こう、行幸
ギョーシ	ぎょうし、仰し、仰視、凝視
ギョーシュク	凝縮
ギョーシュー	ぎょうしゅう、凝聚、凝集
ギョーショー	ぎょうしょう、行商
ギョージ	ぎょうじ、行じ、行持
ギョーズイ	ぎょうずい、行ずい、行水
ギョータイ	凝滞
ギョーチャク	凝着
ギョーテン	ぎょうてん、仰天
ギョーボー	ぎょうぼう、仰望、翹望
ギョーリツ	凝立
ギョーレツ	ぎょうれつ、行列
ギリョー	ぎりょう、議了
ギロン	ぎろん、ギロン、議論
ギンエイ	ぎんえい、吟詠
ギンコー	ぎんこう、吟こう、吟行
ギンショー	ぎんしょう、吟しょう、吟唱、吟誦
ギンミ	ぎんみ、吟味
クカク	くかく、く画、区劃、区画
クガク	くがく、く学、苦学
クギズケ	くぎづけ、くぎ付け、釘付け
クギョー	くぎょう、く行、苦行
クギン	くぎん、苦吟
クサク	くさく、く作、句作
クシ	駆使
クショ	くしょ、く処、区処
クショー	くしょう、く笑、苦笑
クシン	くしん、く心、苦しん、苦心
クジビキ	くじびき、くじ引、くじ引き
クジュ	くじゅ、く授、クジュ、口授
クジュー	くじゅう、く渋、苦渋
クジョ	くじょ、く除、駆除
クセツ	くせつ、く節、苦節
クセン	くせん、く戦、苦戦
クチキキ	口きき、口利き
クチク	くちく、駆逐
クチゴタエ	くちごたえ、口ごたえ、口答え、口答たえ
クチダシ	くちだし、口だし、口出し
クチナオシ	くちなおし、口なおし、口直し
クチュー	くちゅう、く虫、駆虫
クッキョク	くっきょく、屈曲
クッサク	くっさく、掘さく、掘削、掘鑿
クッシン	くっしん、屈伸
クッセツ	くっせつ、くっ折、屈折
クッタク	くったく、くっ託、屈託
クップク	くっぷく、屈伏、屈服
クツジュー	屈従
クトー	くとう、く闘、苦闘
クドー	くどう、く動、駆動
クナン	くなん、く難、苦難
クノー	くのう、く悩、苦悩
クフー	くふう、く夫、工夫
クブン	くぶん、く分、区分
クベツ	くべつ、く別、区別
クミハン	組版
クメン	くめん、く面、工面
クモン	くもん、苦もん、苦悶
クヨー	くよう、く養、供養
クライミング	クライミング
クラガエ	くら替え、鞍替え
クラスタリング	クラスタリング
クリア	クリア
クリアー	クリアー
クリエート	クリエート
クリコシ	くりこし、クリコシ、繰り越し、繰越、繰越し
クリノベ	繰り延べ、繰延、繰延べ
クリョ	くりょ、苦慮
クリンチ	クリンチ
クリーニング	クリーニング
クルイジニ	狂い死に、狂死
クロス	クロス
クロスオーバー	クロスオーバー
クロー	くろう、苦労
クローズ	クローズ
クローズアップ	クローズアップ
クワケ	くわけ、く分、く分け、区分、区分け
クワリ	くわり、く割、く割り、区割、区割り
クンイク	薫育、訓育
クンカイ	くんかい、訓戒、訓誡
クンコク	くんこく、訓告
クンジ	くんじ、訓じ、訓示
クンジョー	くんじょう、くん蒸、燻蒸
クンセン	くんせん、薫染
クンデン	訓電
クントー	くんとう、薫陶
クンドク	訓読
クンドー	くんどう、訓導
クンヨミ	訓よみ、訓読、訓読み
クンリン	くんりん、君臨
クンレイ	訓令
クンレン	くんれん、訓練
クンワ	くんわ、くん話、訓話
クーキデンセン	空気伝染
クーシュー	くうしゅう、空襲
クーソー	くうそう、空そう、空想
クーテン	空転
クーハツ	空はつ、空発
クーバク	くうばく、空爆
クーヒ	空ひ、空費
クーユ	空ゆ、空輸
グゲン	ぐ現、具現
グコー	ぐこう、愚考
グシン	ぐしん、具申
グズー	ぐずう、ぐ通、弘通
グチン	ぐちん、具陳
グビ	ぐび、具備
グブ	ぐぶ、供奉
グホー	ぐほう、ぐ奉、ぐ法、弘法
グユー	ぐゆう、具有
グリセード	グリセード
グリップ	グリップ
グロウ	苦労
グロー	ぐろう、愚ろう、愚弄
グンキョ	群居
グンシュク	軍縮
グンシュー	群集
グンセイ	ぐんせい、群せい、群棲、群生
グンパツ	群発
グンビ	ぐんび、軍備
グンブ	ぐんぶ、群舞
グー	寓、遇
グーキョ	寓居
グーゴ	偶語
グーハツ	偶発
グーモク	寓目
グーユー	偶有
ケイ	啓、慶、敬
ケイアイ	けいあい、敬愛
ケイイ	けいい、敬い、敬意
ケイイン	けいいん、契印
ケイエイ	けいえい、経営、警衛
ケイエン	けいえん、ケイエン、敬遠
ケイオー	ＫＯ
ケイカ	けいか、経か、経過
ケイカイ	けいかい、警戒
ケイカク	けいかく、計画
ケイカン	けいかん、挂冠
ケイガ	けいが、慶が、慶賀
ケイガク	けいがく、掲額
ケイキ	けいき、継き、継起
ケイキョモードー	軽挙妄動
ケイケン	経験
ケイゲン	けいげん、ケイゲン、軽減
ケイコ	けいこ、けい古、稽古
ケイコク	けいこく、警告
ケイコー	けいこう、携行、景仰
ケイゴ	けいご、警固、警護
ケイゴー	契合
ケイサイ	けいさい、ケイサイ、掲載
ケイサン	けいさん、計さん、計算
ケイシ	けいし、刑し、刑死、軽し、軽視
ケイシャ	けいしゃ、傾斜
ケイシュク	慶祝
ケイシュツ	掲出
ケイショク	軽食
ケイショー	継承
ケイシン	けいしん、軽信
ケイジ	けいじ、けい示、兄事、啓示、掲示
ケイジョー	けいじょう、啓上、計上
ケイスー	けいすう、計数
ケイセイ	けいせい、形成
ケイセン	けいせん、けい船、係船、繋船
ケイソク	けいそく、計測
ケイソー	けいそう、係争、繋争、軽装
ケイゾク	けいぞく、係属、継続、繋属
ケイタイ	けいたい、ケイタイ、携帯
ケイチュー	けいちゅう、傾注
ケイチョー	けいちょう、傾聴、敬弔、敬重
ケイトー	けいとう、傾倒、恵投
ケイハツ	けいはつ、啓発
ケイバイ	けいばい、啓培、競売
ケイバク	けいばく、繋縛
ケイビ	けいび、警備
ケイフク	けいふく、敬服
ケイブ	けいぶ、軽侮
ケイベツ	けいべつ、軽べつ、軽蔑
ケイホー	けいほう、警報
ケイボ	けいぼ、敬慕
ケイモー	けいもう、啓もう、啓蒙
ケイヤク	けいやく、契約
ケイユ	けいゆ、経由
ケイヨ	けいよ、恵よ、恵与
ケイヨー	けいよう、形容、掲揚
ケイラ	けいら、警ら、警邏
ケイリ	けいり、ケイリ、経り、経理
ケイリャク	経略
ケイリュー	けいりゅう、けい留、係留、繋留
ケイリョー	けいりょう、計量
ケイレイ	けいれい、ケイレイ、敬礼
ケイレン	けいれん、痙攣
ケガ	けが、ケガ、怪我
ケゲン	化現
ケシャク	挂錫
ケショー	けしょう、化粧
ケソー	けそう、懸想
ケタイ	けたい、け怠、ケタイ、懈怠
ケッカ	けっか、欠か、欠課
ケッカイ	けっかい、決壊、決潰
ケッキ	けっき、けっ起、決起、蹶起
ケッキュー	けっきゅう、結球
ケッキョ	けっきょ、穴居
ケッキン	けっきん、欠勤、缺勤
ケッコン	けっこん、けっ婚、ケッコン、結こん、結婚
ケッコー	けっこう、けっ航、けっ行、けっ講、欠航、決行、結講
ケッサイ	けっさい、決済、決裁、潔斎
ケッサツ	けっさつ、結さつ、結紮
ケッサン	けっさん、決算
ケッシュツ	けっしゅつ、傑出
ケッシュー	けっしゅう、結集
ケッショ	けっしょ、血書
ケッショク	けっしょく、欠食
ケッショー	けっしょう、結晶
ケッシン	けっしん、決心、結審
ケッセイ	けっせい、ケッセイ、結成
ケッセキ	けっせき、欠席、缺席
ケッセン	けっせん、決戦、血戦
ケッソク	けっそく、結束
ケッソン	けっそん、欠損、缺損
ケッタイ	けったい、ケッタイ、結滞
ケッタク	けったく、結託
ケッチャク	けっちゃく、決着
ケッテイ	けってい、けっ定、決定
ケットー	けっとう、決闘、結党
ケッパイ	けっぱい、欠配
ケッパツ	けっぱつ、結髪
ケッパン	けっぱん、血判
ケッピョー	結氷
ケツイ	けつい、決い、決意
ケツギ	けつぎ、決議
ケツゴー	けつごう、結合
ケツジツ	結実
ケツジョ	欠如、缺如、闕如
ケツジョー	けつじょう、欠場
ケツダン	けつだん、決断、結団
ケツベツ	けつべつ、決別、訣別
ケツボー	欠乏、缺乏
ケツメイ	結盟
ケツラク	欠落、缺落
ケツレイ	欠礼
ケツレツ	決裂
ケツロ	けつろ、結露
ケツロン	けつろん、結論
ケネン	けねん、懸念
ケン	検、験
ケンアン	けんあん、検案
ケンイン	けん引、検印、牽引
ケンエイ	けんえい、兼営、献詠
ケンエキ	けんえき、検疫
ケンエツ	けんえつ、検閲
ケンエン	けんえん、嫌煙
ケンオ	けんお、けん悪、嫌お、嫌悪
ケンオン	けんおん、検温
ケンカ	けんか、けん化、ケンカ、喧嘩、献花、鹸化
ケンカク	けんかく、懸隔
ケンカン	けんかん、兼官
ケンガク	けんがく、兼学、研学、見学
ケンガン	けんがん、検がん、検眼
ケンキ	けんき、嫌忌
ケンキュー	けんきゅう、ケンキュウ、研究
ケンキョ	けんきょ、検挙
ケンキン	けんきん、兼勤、献金
ケンギ	けんぎ、建議
ケンギョー	けんぎょう、兼業
ケンケツ	けんけつ、ケンケツ、献血
ケンケンフクヨー	けんけんふくよう、拳々服膺、拳拳服膺
ケンゲン	けんげん、建言、献言、顕現
ケンコク	けんこく、ケンコク、建国
ケンコー	兼行
ケンサ	けんさ、ケンサ、検さ、検査
ケンサク	けんさく、ケンサク、検索、献策
ケンサツ	けんさつ、検察、検札、賢察
ケンサン	けんさん、ケンサン、研さん、研鑽
ケンザイ	けんざい、顕在
ケンザン	けんざん、検ざん、検算、見参、験ざん、験算
ケンシ	けんし、検し、検屍、検死、検視
ケンシュ	けんしゅ、堅守
ケンシュツ	検出
ケンシュー	けんしゅう、兼修、検収、献酬、研修
ケンショク	兼職
ケンショー	けんしょう、検証、謙称、顕彰
ケンシン	けんしん、検診、検針、献身
ケンジ	けんじ、堅持、顕示
ケンジョー	けんじょう、献上
ケンスイ	けんすい、ケンスイ、懸垂
ケンセイ	けんせい、けん制、牽制
ケンセキ	けんせき、けん責、譴責
ケンセツ	けんせつ、ケンセツ、兼摂、建設
ケンセン	けんせん、献せん、献饌
ケンゼツ	懸絶
ケンソク	検束
ケンソン	けんそん、謙そん、謙遜
ケンゾー	けんぞう、ケンゾウ、建造
ケンタイ	けんたい、けん怠、倦怠、兼帯
ケンタン	けんたん、検たん、検痰
ケンチ	けんち、検地、検知、軒輊
ケンチク	けんちく、ケンチク、建築
ケンテイ	けんてい、検定、献呈
ケンデン	けんでん、けん伝、喧伝
ケント	けんと、建と、建都
ケントー	けんとう、健闘、検討、見とう、見当
ケンドジューライ	けん土重来、捲土重来
ケンドチョーライ	けん土重来、捲土重来
ケンニョー	検尿
ケンニン	けんにん、兼任
ケンノー	けんのう、献納
ケンパ	けんぱ、検ぱ、検波
ケンパイ	けんぱい、献ぱい、献杯、献盃
ケンパク	けんぱく、建ぱく、建白
ケンビ	けんび、兼備
ケンピン	検品
ケンブツ	けんぶつ、見物
ケンブン	けんぶん、検分、見分、見聞
ケンベン	けんべん、検便
ケンペイ	けんぺい、兼ぺい、兼併
ケンポ	けんぽ、兼ぽ、兼補
ケンポン	けんぽん、献ぽん、献本
ケンマ	けんま、研ま、研摩、研磨
ケンマシアゲ	研摩仕上、研摩仕上げ
ケンム	けんむ、兼務
ケンモン	けんもん、検問、見聞
ケンヤク	けんやく、倹約
ケンユー	けんゆう、兼有
ケンヨク	謙抑
ケンヨー	けんよう、兼用、顕揚
ゲイイン	げいいん、鯨飲
ゲイゲキ	迎撃
ゲイゴー	迎合
ゲイセツ	迎接
ゲキ	激
ゲキエツ	激越
ゲキカ	げきか、劇か、劇化、激か、激化
ゲキゲン	激減
ゲキサイ	撃砕
ゲキサン	げきさん、激賛
ゲキショー	激賞
ゲキジョー	げきじょう、撃じょう、撃攘、激情
ゲキセン	げきせん、激戦
ゲキソー	げきそう、激走
ゲキゾー	激増
ゲキタイ	げきたい、撃退
ゲキチン	げきちん、撃沈
ゲキツイ	撃墜
ゲキトツ	げきとつ、ゲキトツ、激突
ゲキトー	げきとう、激闘
ゲキド	げきど、激怒
ゲキドー	激動
ゲキハ	げきは、撃は、撃破
ゲキハツ	激発
ゲキフン	激憤
ゲキヘン	劇変、激変
ゲキメツ	撃滅
ゲキレイ	げきれい、激励
ゲキロン	激論
ゲコー	げこう、下向、下校
ゲゴク	げごく、下獄
ゲザ	下座
ゲザン	げざん、下ざん、下山
ゲシャ	げしゃ、下車
ゲシュク	げしゅく、下宿
ゲショウ	化粧
ゲジ	げじ、下じ、下知
ゲジョー	げじょう、下乗、下城
ゲセン	げせん、下船
ゲダツ	げだつ、解脱
ゲチ	下知
ゲッコー	げっこう、激昂、激高
ゲドク	げどく、解毒
ゲネツ	げねつ、解熱
ゲハン	げはん、下はん
ゲバ	下馬
ゲヤ	下野
ゲラク	げらく、下落
ゲリ	下痢
ゲンアツ	減圧
ゲンイン	げんいん、減員
ゲンエキ	げんえき、減益
ゲンカ	げんか、喧嘩、減か、減価
ゲンカイ	げんかい、厳戒
ゲンガク	げんがく、減額
ゲンキャク	減却
ゲンキュー	げんきゅう、減給、言及
ゲンキョク	限局
ゲンキン	げんきん、ゲンキン、厳禁
ゲンケイ	げんけい、減刑
ゲンコク	げんこく、減石
ゲンサイ	げんさい、減殺
ゲンサン	げんさん、減産
ゲンザン	げんざん、減ざん、減算
ゲンシ	げんし、減し、減資
ゲンシャ	げんしゃ、減車
ゲンシュ	げんしゅ、厳守
ゲンシュツ	現出
ゲンシュー	げんしゅう、減収
ゲンショク	げんしょく、減食
ゲンショー	げんしょう、減少
ゲンジツバナレ	現実ばなれ、現実離れ
ゲンジュー	げんじゅう、現住
ゲンスイ	げんすい、ゲンスイ、減水、減衰
ゲンスー	減数
ゲンセン	げんせん、厳選
ゲンゼイ	減税
ゲンゼン	げんぜん、現前
ゲンソク	げんそく、減速
ゲンソン	げんそん、厳存、減損、現存
ゲンソー	げんそう、幻想、現そう、現送
ゲンゾク	げんぞく、げん俗、還俗
ゲンゾン	現存
ゲンゾー	げんぞう、現像
ゲンタイ	げんたい、減退
ゲンタツ	げんたつ、厳達
ゲンタン	げんたん、厳探、減反
ゲンダン	厳談
ゲンテイ	げんてい、限定
ゲンテン	げんてん、減点
ゲンナリ	げんなり、ゲンナリ
ゲンバツ	厳罰
ゲンパイ	げんぱい、減ぱい、減配
ゲンピ	げんぴ、厳秘
ゲンプク	げんぷく、元ぷく、元服
ゲンプー	げんぷう、厳ぷう、厳封
ゲンポー	げんぽう、減ぽう、減俸
ゲンメイ	げんめい、厳命、言明
ゲンメツ	げんめつ、幻滅
ゲンメン	減免
ゲンモー	げんもう、減もう、減耗
ゲンユー	げんゆう、現有
ゲンヨー	げんよう、現用
ゲンリョー	げんりょう、減量
ゲンレイ	げんれい、厳令
ゲンワク	げんわく、げん惑、幻惑、眩惑
コ	こ、鼓
コウリ	こうり、小売、小売り
コオー	こおう、呼応
コカ	こか、こ化、固か、固化
コカツ	こかつ、枯渇、涸渇
コガレジニ	焦がれ死
コキュー	こきゅう、呼吸
コギ	こぎ、こ疑、狐疑
コク	刻
コクイン	こくいん、刻印
コクグー	酷遇
コクシ	こくし、酷し、酷使
コクショク	穀食
コクジ	こくじ、告示、酷似
コクソ	こくそ、告そ、告訴
コクチ	こくち、告知
コクハク	こくはく、告白
コクハツ	こくはつ、告発
コクヒョー	酷評
コクフク	こくふく、克復、克服
コクベツ	告別
コクユ	告諭
コゴー	こごう、こ号、呼号
コザ	こざ、こ座、胡坐
コザイク	こざいく、小細工
コシ	枯死
コシイレ	こしいれ、こし入れ、輿入れ
コシツ	こしつ、固執
コシュ	こしゅ、固守
コシュー	こしゅう、呼集、固執
コショー	呼称、扈従、故障、誇称
コジ	こじ、こ持、固持、固辞、誇示
コジュー	こじゅう、こ従、扈従
コスイ	鼓吹
コセコセ	こせこせ
コソダテ	こそだて、子そだて、子育て
コチャク	固着
コチョー	こちょう、誇張
コッカイ	こっかい、告解
コック	こっく、こっ苦、刻苦
コッセツ	こっせつ、こっ折、骨折
コテイ	こてい、こ定、固定
コト	糊塗
コトズケ	ことづけ、こと付、こと付け、言づけ、言付、言付け
コドー	こどう、こ動、鼓動
コピー	コピー
コフク	こふく、こ腹、鼓腹
コブ	鼓舞
コミット	コミット
コミュニケート	コミュニケート
コメント	コメント
コモリ	こもり、子もり、子守、子守り
コヨー	こよう、こ用、雇傭、雇用
コリツ	こりつ、こ立、孤立
コリョ	こりょ、顧慮
コロシアイ	殺しあい、殺し合い
コロモガエ	ころもがえ、更衣、衣更え、衣替え
コワク	こわく、こ惑、蠱惑
コンイン	こんいん、婚姻
コンガン	こんがん、懇願
コンキャク	困却
コンキュー	こんきゅう、困窮
コンケツ	混血
コンコー	こんこう、混こう、混交、混淆、渾こう、渾淆
コンゴー	こんごう、混合
コンサク	混作
コンザイ	混在
コンザツ	こんざつ、混雑
コンショク	混食
コンシン	混信
コンジ	こんじ、根治
コンスイ	こんすい、こん睡、昏睡
コンセイ	こんせい、こん生、懇請、混成、混生
コンセン	こんせん、混戦、混線
コンゼツ	根絶
コンタクト	コンタクト
コンダク	こんだく、コンダク、混濁、溷濁
コンダン	こんだん、懇談
コンチ	こんち、根治
コントロール	コントロール
コントー	こんとう、こん倒、昏倒
コンドー	こんどう、混同
コンニュー	混入
コンバート	コンバート
コンパイ	こんぱい、困ぱい、困憊
コンボー	こんぼう、懇望、混紡
コンポー	こんぽう、こん包、梱包
コンメイ	こんめい、昏迷、混迷
コンモー	こんもう、懇望
コンヤク	こんやく、婚約
コンヨク	こんよく、混浴
コンヨー	こんよう、混用
コンラン	こんらん、混乱
コンリュー	こんりゅう、建立
コンワ	こんわ、混和
コンワク	困惑
コー	抗、航
コーアツ	こうあつ、降圧
コーアン	こうあん、考案
コーイ	こうい、攻囲、更い、更衣、行い、行為
コーイツ	こういつ、後いつ、後逸
コーイン	こういん、こう引、勾引、拘引
コーウン	こううん、耕うん、耕耘
コーエキ	こうえき、交易
コーエツ	こうえつ、校閲
コーエン	こうえん、公演、口演、好演、後えん、後援、講演
コーオンショードン	高温焼鈍
コーカ	こうか、こう化、硬化、膠化、降下、降嫁
コーカイ	こうかい、こう海、公開、後かい、後悔、更改、航海
コーカク	こうかく、降格
コーカン	こうかん、コウカン、交かん、交感、交換、交歓、交驩、公刊、校勘
コーガイ	こうがい、こう外、コウガイ、口がい、口外、慷慨
コーキ	こうき、興き、興起
コーキュー	こうきゅう、攻究、考究、講究、購求
コーキョ	こうきょ、公許、抗拒、薨去
コーキョー	こうきょう、口供
コーキン	こうきん、拘禁
コーギ	こうぎ、抗議、講義
コーギョー	こうぎょう、こう行、興行
コーギン	こうぎん、高吟
コーグン	こうぐん、行軍
コーグー	こうぐう、厚遇
コーケン	こうけん、こう見、後けん、後見、貢献
コーゲキ	こうげき、コウゲキ、攻げき、攻撃
コーゲン	こうげん、こう言、公言、広げん、広言、抗言、高言
コーコク	こうこく、公告、広告、抗告
コーコー	こうこう、こう行、孝こう、孝行、航行
コーゴー	こうごう、こう合、コウゴウ、交合
コーサ	こうさ、交叉、交差、考査
コーサイ	こうさい、交際
コーサク	こうさく、こう作、コウサク、交錯、工作、耕作
コーサツ	こうさつ、コウサツ、絞殺、考察
コーサン	こうさん、降さん、降参
コーシ	こうし、更始、行使
コーシャ	こうしゃ、こう車、降車
コーシャク	こうしゃく、講釈
コーシュ	こうしゅ、こう手、拱手
コーシュー	こうしゅう、講習
コーショク	こうしょく、交織、降職
コーショー	こうしょう、こう笑、交しょう、交渉、公称、口しょう、口承、口誦、哄笑、考しょう、考証、高唱
コーシン	こうしん、こう進、亢進、交信、後進、昂進、更新、行進、高進
コージ	こうじ、公示、工事
コージュ	こうじゅ、コウジュ、口受、口授
コージュツ	公述、口述、後述
コージョ	こうじょ、扣除、控除
コージョー	こうじょう、こう上、コウジョウ、向上
コーセイ	こうせい、更正、更生、校正、構成、較正
コーセツ	こうせつ、交接
コーセン	こうせん、交戦、公選、抗戦
コーソ	こうそ、公訴、控訴
コーソク	こうそく、コウソク、拘束、梗塞
コーソー	こうそう、後そう、後送、抗争、構想
コーゾク	こうぞく、後続
コータイ	こうたい、交代、交替、後たい、後退
コータツ	こうたつ、口達
コータン	こうたん、降誕
コーダク	黄濁
コーダン	こうだん、高談
コーチ	コーチ、拘ち、拘置
コーチク	こうちく、コウチク、構築
コーチャク	こうちゃく、こう着、膠着、降着
コーチョク	こうちょく、硬直
コーチョー	こうちょう、紅潮、高調
コーティング	コーティング
コーテイ	こうてい、公定、更訂、校てい、校訂、肯定
コーテツ	こうてつ、更迭
コーテン	こうてん、公転、好転
コーディネート	コーディネート
コーデイ	こうでい、拘泥
コートー	こうとう、こう頭、叩頭、好投、昂騰、高騰
コードク	こうどく、講読、購読
コードー	こうどう、行動
コーニュー	こうにゅう、購入
コーニン	こうにん、公認、降任
コーハイ	こうはい、こう配、交配、荒廃
コーハン	こうはん、公判、撹はん、撹拌
コーバイ	公売、購買
コーバン	こうばん、降板
コーヒ	こうひ、光ひ、光被
コーヒョー	こうひょう、こう表、公表、講評
コービ	こうび、交尾
コーフ	こうふ、交ふ、交付、公ふ、公布
コーフク	こうふく、降伏、降服
コーフン	こうふん、亢奮、昂奮、興奮
コーブ	こうぶ、荒ぶ、荒蕪
コーベン	こうべん、抗弁
コーホー	こうほう、広報
コーボ	こうぼ、公募
コーボー	こうぼう、好防
コーヤク	こうやく、公約、口約
コーユー	こうゆう、交遊、公有
コーヨー	こうよう、孝養、昂揚、紅葉、高揚、黄葉
コーラク	こうらく、攻落
コーラン	こうらん、撹乱
コーリャク	こうりゃく、後略、攻略
コーリュー	こうりゅう、こう流、こう留、交流、勾留、拘留、興隆
コーリョ	こうりょ、考慮
コーリョー	考量
コーリン	こうりん、降りん、降臨
コーロン	こうろん、口論
コーロンオツバク	甲論乙駁
コーワ	こうわ、こう話、コウワ、媾和、講和、講話
ゴ	伍
ゴエイ	ごえい、護衛
ゴカイ	ごかい、誤解
ゴキ	ご記、誤記
ゴクシ	ごくし、獄死
ゴサン	ごさん、誤算
ゴシャ	ごしゃ、誤写
ゴシン	ごしん、ご信、ご審、誤信、誤審、誤診
ゴジ	ごじ、ご持、護持
ゴジョ	ごじょ、ご助、互助
ゴジョー	ごじょう、互譲
ゴスイ	ごすい、午睡
ゴセイ	ごせい、互生
ゴセン	ごせん、ご選、互選
ゴソー	ごそう、ご送、護送
ゴソーサ	ご操作、誤操作
ゴダン	ごだん、誤断
ゴチソー	ごちそう、ご馳走、御ち走、御馳走
ゴツゴツ	ごつごつ、ゴツゴツ
ゴデン	ごでん、誤伝
ゴトク	ごとく、悟得
ゴドク	誤読
ゴドーサ	誤動作
ゴニュー	ご入、悟入
ゴニン	ごにん、ご認、誤認
ゴブサタ	ごぶさた、ご無沙汰、御無沙汰
ゴブン	ごぶん、誤聞
ゴホー	ごほう、ご報、誤報
ゴヤク	ごやく、誤訳
ゴヨー	ご用、誤用
ゴロネ	ごろ寝
ゴワゴワ	ごわごわ、ゴワゴワ、強強
ゴング	ごんぐ、欣求
ゴンジョー	ごんじょう、言上
ゴー	号
ゴーイ	ごうい、合い、合意
ゴーイツ	合いつ、合一
ゴーカク	ごうかく、ゴウカク、合格
ゴーカン	ごうかん、合かん、合歓、強かん、強姦
ゴーキュー	ごうきゅう、号泣
ゴーギ	ごうぎ、合議
ゴーケイ	ごうけい、ゴウケイ、合計
ゴーゴ	ごうご、豪語
ゴーシ	ごうし、合し、合祀、合資
ゴーセイ	ごうせい、合せい、合成、強請
ゴーソ	ごうそ、強そ、強訴
ゴーダツ	強奪
ゴーチン	ごうちん、ごう沈、轟沈
ゴードー	ごうどう、ゴウドウ、合どう、合同
ゴーブク	降伏
ゴーモン	ごう問、拷問
ゴーユー	ごうゆう、豪遊
ゴーリャク	劫掠、劫略
ゴーリュー	ごうりゅう、合流
ゴーリョク	合力
ゴールイン	ゴールイン
ゴーレイ	ごうれい、号令
サイエン	さいえん、再演、再縁
サイカ	さいか、さい下、再か、再嫁、裁か、裁可、西か、西下
サイカイ	さいかい、さい会、さい開、再会、再開、斎戒、際会
サイカク	さいかく、才覚
サイカン	さいかん、再刊
サイキ	さいき、さい忌、再帰、再起
サイキョ	さいきょ、再挙、裁許
サイギ	さいぎ、さい疑、さい議、再議、猜疑
サイク	さいく、さい工、サイク、細く、細工
サイクツ	さいくつ、採掘
サイクリング	サイクリング
サイケイ	さいけい、再掲
サイケイレイ	最敬礼
サイケツ	さいけつ、採決、採血、裁決
サイケン	さいけん、さい建、さい検、再建、再検
サイケントー	再検討
サイゲン	さいげん、さい現、再現
サイコク	さいこく、催告
サイコン	さいこん、再婚
サイコー	さいこう、再考、再興、採鉱、砕こう、砕鉱
サイシ	再思
サイシキ	さいしき、さい色、彩色
サイシドー	再始動
サイシュ	さいしゅ、さい取、さい種、採取、採種
サイシュッパツ	さいしゅっぱつ、再しゅっぱつ、再出発
サイシュー	さいしゅう、さい集、採集
サイショ	さいしょ、さい書、細書
サイショク	さい食、彩色、菜食
サイシン	さいしん、再審
サイスン	採寸
サイセイ	さいせい、さい生、再生、再製
サイセキ	さいせき、さい石、採石
サイセツ	さいせつ、さい説、再説、細説
サイセン	再選
サイソク	さいそく、催促
サイソー	さいそう、さい送、再送
サイタイ	さい帯、妻帯
サイタク	さいたく、採択
サイタン	さいたん、採炭
サイダン	さいだん、さい断、裁断
サイチク	再築
サイチョー	さいちょう、さい調、再調
サイテイ	さいてい、さい定、再訂、裁定
サイテン	さいてん、さい点、さい転、再転、採点
サイド	さいど、済度
サイドク	再読
サイニョー	採尿
サイニン	さい認、再任、再認
サイネン	さいねん、再燃
サイノー	さいのう、さい納、採納
サイハイ	さい配、再拝、采配
サイハッケン	さいはっけん、再はっけん、再はっ見、再発見
サイハツ	さい発、再発
サイハン	さいはん、再版
サイバイ	さいばい、栽培
サイヒョー	さいひょう、砕ひょう、砕氷
サイフ	さいふ、採譜
サイブン	さいぶん、さい分、細分
サイヘン	さいへん、さい編、再編
サイベツ	さい別、細別
サイホー	さいほう、再訪、採訪、裁縫
サイユ	さいゆ、採油
サイユー	さいゆう、西ゆう、西遊
サイヨー	さいよう、さい用、採用
サイライ	さい来、再来
サイリョー	さいりょう、宰領、裁量
サイリン	さいりん、再臨
サイロク	採録、載録
サイロン	再論、細論
サイワリアテ	再割り当て、再割当、再割当て
サイン	サイン
サエツ	さえつ、査閲
サカウラミ	さかうらみ、逆恨、逆恨み
サカナデ	さかなで、逆なで
サキオクリ	先送り
サキガケ	さきがけ、先駆け、魁
サキドリ	さきどり、サキドリ、先どり、先取り
サキマワリ	先回り
サギ	詐欺
サギョー	さぎょう、さ業、作業
サクイ	作為
サクオー	策応
サクガ	さくが、作が、作画
サクゲン	さくげん、削減、溯源、遡源
サクゴ	さくご、錯誤
サクザツ	錯雑
サクシ	さくし、作し、作詞、作詩、錯し、錯視
サクシュ	さくしゅ、さく取、搾取
サクジョ	さくじょ、削除
サクズ	さくず、作ず、作図
サクセイ	さくせい、さく井、作成、作製、鑿井
サクソー	さくそう、錯そう、錯綜
サクテイ	さくてい、策定
サクドー	さくどう、策動
サクニュー	さく乳、搾乳
サクヒョー	作表
サクブン	さくぶん、さく文、作文
サクボー	さくぼう、策謀
サクユ	搾油
サクラン	さくらん、錯乱
サクリツ	冊立
サクリャク	策略
サクレツ	さくれつ、さく裂、炸れつ、炸裂
サケイ	さけい、左傾
サケン	さけん、差遣
サコク	さこく、さ国、鎖国
ササツ	ささつ、査察
サシイレ	さしいれ、さし入れ、差しいれ、差し入れ、差入、差入れ
サシオサエ	さしおさえ、差し押え、差し押さえ、差押、差押え、差押さえ
サシキ	さし木、挿し木、挿木
サシズ	さしず、指ず、指図
サシドメ	差し止め、差止、差止め
サシムカイ	さしむかい、差し向い、差し向かい、差向い
サシュ	さ取、詐取
サシュー	査収
サショー	さしょう、さ証、査証、詐称
サジェスト	サジェスト
サジェッション	サジェッション
サスペンド	サスペンド
サセツ	させつ、左折
サセン	させん、左遷
サゼンダ	左前打
サタ	沙汰
サタン	さたん、さ嘆、嗟嘆、嗟歎、左たん、左袒
サッカ	さっか、サッカ、作か、作歌
サッカク	さっかく、さっ覚、サッカク、錯覚
サッキュー	さっきゅう、遡及
サッキョク	さっきょく、サッキョク、作曲
サッキン	さっきん、殺菌
サッコー	さっこう、作こう、作興
サッシ	さっし、察し
サッショー	さっしょう、殺傷
サッシン	さっしん、刷新
サッスイ	さっすい、撒水
サッチ	さっち、さっ知、サッチ、察知
サッチュー	さっちゅう、さっ虫
サットー	さっとう、さっ到、サットウ、殺到
サッパ	さっぱ、サッパ、撒播
サップ	さっぷ、サップ、撒布
サツエイ	さつえい、撮影
サツガイ	さつがい、殺害
サツリク	さつりく、殺りく、殺戮
サテイ	さてい、さ定、査定
サテツ	さてつ、サテツ、蹉跌
サドク	査読
サドー	さどう、さ動、作どう、作動
サハイ	さはい、差はい、差配
サバサバ	さばさば、サバサバ
サプライ	サプライ
サベツ	さべつ、さ別、サベツ、差別
サボタージュ	サボタージュ
サポート	サポート
サムザム	さむざむ、寒々、寒ざむ、寒寒
サモン	さもん、さ問、査問
サユー	さゆう、さ右、サユウ、左右
サヨー	作用
サン	参、算
サンイツ	さんいつ、散佚、散逸
サンカ	さんか、さん加、さん化、参か、参加、酸か、酸化
サンカイ	さんかい、さん会、さん開、参会、散会、散開
サンカク	さんかく、さん画、参画
サンカン	さんかん、さん観、参看、参観
サンガ	さんが、参が、参賀
サンガク	さんがく、さん学、参学
サンキュー	さんきゅう、さん休、参究、産休
サンキョ	さんきょ、さん居、山居
サンキン	さんきん、参勤、参覲
サンギョー	さんぎょう、鑽仰
サングー	さんぐう、さん宮、参宮
サンケイ	さんけい、サンケイ、参けい、参詣
サンケン	さんけん、さん見、散見
サンゲ	さんげ、散げ、散華
サンコツ	さんこつ、さん骨、散骨
サンコー	さんこう、さん向、さん孔、さん考、サンコウ、参向、参考、鑽孔
サンサク	さんさく、散策
サンザイ	さんざい、さん在、さん財、散在、散財
サンシ	さんし、さん思、三し、三思
サンシャク	参しゃく、参酌
サンシュツ	さん出、産出、算出
サンシュー	さんしゅう、さん集、参集
サンショク	さんしょく、さん食、蚕食
サンショー	さんしょう、三唱、参照
サンシン	さんしん、さん進、サンシン、三振、参しん、参進
サンジ	さんじ、賛辞
サンジョ	さんじょ、さん除、芟じょ、芟除、賛じょ、賛助
サンジョー	さんじょう、さん上、参上
サンスイ	さんすい、さん水、サンスイ、撒水、散水
サンセイ	さんせい、さん成、さん政、参政、賛成
サンセキ	さんせき、さん積、山せき、山積
サンセン	さんせん、さん戦、参戦
サンゼン	参禅
サンタイベツ	三大別
サンタン	さんたん、三たん、三嘆、三歎、讚歎、賛嘆
サンダイ	さんだい、さん内、さん大、参内、散大
サンダツ	さんだつ、さん奪、簒奪
サンダン	さんだん、さん段、算段
サンチャク	さんちゃく、さん着、参着
サンチョー	さんちょう、さん朝、参朝
サンテイ	さんてい、さん定、算定
サンテン	さんてん、さん点、散点
サンデン	さんでん、さん殿、参でん、参殿
サンドー	さんどう、さん同、さん堂、参堂、賛同
サンニュー	さん入、参入、算入
サンニョー	さん用、算用
サンパイ	さんぱい、三ぱい、三拝、参ぱい、参拝、酸ぱい、酸敗
サンパイキューハイ	三拝九拝
サンパツ	さんぱつ、サンパツ、散ぱつ、散発、散髪
サンビ	さんび、さん美、讚美、賛美
サンプ	さんぷ、参ぷ、参府、撒布、散ぷ、散布
サンプリング	サンプリング
サンプル	サンプル
サンポ	さんぽ、散ぽ、散歩
サンヨ	さんよ、参よ、参与
サンヨー	さんよう、さん用、算用
サンラク	さんらく、さん落、惨落
サンラン	さんらん、さん乱、さん卵、散らん、散乱、産卵
サンレツ	さん列、参列
サンロー	さんろう、参ろう、参篭、参籠
サーカムスクライブ	サーカムスクライブ
サービス	サービス
サーフィン	サーフィン
サーブ	サーブ
ザイイ	在い、在位
ザイエキ	在役
ザイカ	ざいか、在か、在荷
ザイカン	ざいかん、在官
ザイガク	在学
ザイキョー	ざい京、在京、在郷
ザイキン	在勤
ザイク	細工
ザイコ	ざいこ、在こ、在庫
ザイコク	在国
ザイコー	在校
ザイシツ	在室
ザイシャ	在社
ザイシュク	在宿
ザイショク	在職
ザイジュー	ざいじゅう、在住
ザイセイ	ざいせい、在世
ザイセキ	在席、在籍
ザイソク	催促
ザイタク	ざいたく、在宅
ザイチュー	在中
ザイチョー	ざいちょう、在庁、在朝
ザイテイ	在廷
ザイテン	ざいてん、在天
ザイトー	財投
ザイニチ	ざいにち、在日
ザイニン	ざいにん、在任
ザイフ	ざいふ、在府
ザイリュー	ざいりゅう、在留
ザガ	ざが、坐臥、座が
ザコネ	ざこ寝、雑魚寝
ザシ	坐し、坐視、座し、座視
ザショク	坐食、座食
ザショー	ざしょう、ざ傷、ザショウ、坐礁、座礁、挫傷
ザジョー	坐乗、座乗
ザス	坐洲、座州
ザセツ	ざせつ、ざ折、ザセツ、挫折
ザゼン	ざぜん、ザゼン、座禅
ザタ	沙汰
ザダン	座談
ザッキ	ざっき、雑記
ザッキョ	ざっきょ、雑居
ザッコン	ざっこん、雑婚
ザッコー	雑交
ザッサン	ざっさん
ザッショク	ざっしょく、雑食
ザットー	ざっとう、雑沓、雑踏、雑鬧
ザツジュー	ざつじゅう、雑じゅう、雑糅、雑蹂
ザツダン	ざつだん、雑談
ザメツ	ざめつ、ざ滅
ザライ	ざらい、坐来
ザワザワ	ざわざわ、ザワザワ、騒騒
ザン	算
ザンガイ	ざんがい、残がい、残害
ザンキ	ざんき、ザンキ、慙愧
ザンギョー	ざんぎょう、残業
ザンゲ	ざんげ、ザンゲ、懺悔
ザンゲン	ざんげん、ざん言、讒言
ザンサツ	ざんさつ、惨殺、斬殺
ザンシ	ざんし、ざん死、惨死、慙死
ザンシュ	ざんしゅ、ざん首、斬首
ザンソ	ざんそ、ざん訴、讒訴
ザンソン	残存
ザンゾン	残存
ザンチ	残置
ザンテイ	ざんてい、暫定
ザンニュー	竄入
ザンパイ	ざんぱい、ザンパイ、惨ぱい、惨敗
ザンパツ	斬髪
ザンボー	ざんぼう、讒謗
ザンヨウ	算用
ザンリュー	残留
ザンルイ	残るい、残塁
シ	資
シアイ	しあい、し合、し合い、試合、試合い
シアン	しあん、思案
シイ	思惟
シイク	しいく、し育、飼育
シイン	しいん、し飲、試飲
シウンテン	し運転、試運転
シェイプアップ	シェイプアップ
シエキ	しえき、し役、使役
シエン	しえん、し援、し演、支えん、支援、試演
シオクリ	しおくり、し送、し送り、仕送、仕送り
シオヤキ	しおやき、塩焼、塩焼き
シカイ	しかい、し会、司会
シカエシ	しかえし、し返し、仕返し
シカト	シカト
シカン	しかん、仕かん、仕官、弛かん、弛緩
シガン	しがん、し願、志願
シキ	指揮
シキビ	しきび、シキビ、式び、式微
シキベツ	しきべつ、シキベツ、識別
シキュー	支給
シキョ	し去、死去
シキョー	しきょう、し供、し教、指教、示教、試供
シキリナオシ	しきりなおし、しきり直し、仕切りなおし、仕切り直し、仕切直し
シキングリ	資金ぐり、資金繰り
シギ	私議
シギョー	しぎょう、し業、始業
シクツ	しくつ、し掘、試掘
シクハック	しくはっく、四苦八苦
シケツ	しけつ、し血、止血
シケン	しけん、し験、試験
シゲキ	しげき、し激、シゲキ、刺戟、刺激
シコ	四顧、指呼
シコー	しこう、し好、伺候、嗜好、志向、思考、指向、施工、施行、祗候、試行
シゴ	し語、私ご、私語
シゴト	しごと、仕事
シサ	示さ、示唆
シサク	しさく、し作、し策、し索、思索、施策、試作、詩作
シサツ	しさつ、し殺、刺殺、視察
シサン	しさん、し散、し算、四さん、四散、試さん、試算
シザン	しざん、死ざん、死産
シシキ	ししき、し式、司式
シシク	ししく、獅子吼
シシャ	ししゃ、し写、し射、試写、試射
シシャゴニュー	四捨五入
シシュ	ししゅ、し守、死守
シシュク	し宿、止宿、私淑
シシュツ	し出、シシュツ、支出
シシュー	ししゅう、刺しゅう、刺繍
シショク	ししょく、し食、至嘱、試食
シショー	ししょう、し傷、し承、し消、し笑、シショウ、嗤笑、師承、死傷、私消
シシン	ししん、し診、視診
シジ	し事、し持、し示、師事、指示、支持
シジュツ	し術、施術
シジュン	しじゅん、諮詢
シジョー	しじょう、し乗、試乗
シスイ	しすい、試すい、試錐
シセイ	しせい、し製、試製
シセキ	しせき、し尺、咫尺
シセツ	しせつ、し設、施設
シソー	しそう、使そう、使嗾、使送、指そう、指嗾、試そう、試走
シゾー	しぞう、し蔵、死蔵、私蔵
シタウケ	したうけ、下請、下請け
シタウチ	したうち、舌うち、舌打ち
シタガキ	したがき、下書、下書き
シタク	したく、し度、仕度、支度
シタシク	したしく、親しく
シタシラベ	したしらべ、下しらべ、下調べ
シタドリ	したどり、下取、下取り
シタミ	したみ、下見
シダン	しだん、し弾、指弾
シチテンハッキ	七転八起、七顛八起
シチテンバットー	七転八倒、七顛八倒
シチョー	しちょう、し張、し聴、シチョウ、弛張、視聴、試聴
シッカ	しっか、シッカ、失か、失火
シッカク	しっかく、シッカク、失格
シッカン	しっかん、シッカン、失陥
シッキャク	しっきゃく、失脚
シッキン	しっきん、失禁
シック	しっく、しっ駆、疾駆
シッケイ	しっけい、失敬
シッケツシ	失血死
シッケン	しっけん、しっ権、失権
シッコ	しっこ、しっ呼、シッコ、疾呼
シッコー	しっこう、しっ行、シッコウ、執行、失効、膝行
シッサク	しっさく、失策、失錯
シッシ	しっし、しっ視、シッシ、嫉視
シッショク	しっしょく、失職
シッショー	しっしょう、しっ笑、失笑
シッシン	しっしん、しっ心、失心、失神
シッセイ	しっせい、しっ正、叱正
シッセキ	しっせき、しっ責、しっ跡、叱責、失跡
シッソク	しっそく、失速
シッソー	しっそう、執奏、失そう、失踪、疾走
シッタ	しった、シッタ、叱咤
シッタツ	執達
シッチョー	失調
シッツイ	しっつい、失墜
シッテン	しってん、シッテン、失点
シッテンバットー	七転八倒、七顛八倒
シット	しっと、嫉妬
シットー	しっとう、執刀
シッパイ	しっぱい、シッパイ、失敗
シッピ	しっぴ、櫛比
シッピツ	しっぴつ、シッピツ、執筆
シップ	しっぷ、シップ、湿布
シツギ	しつぎ、シツギ、質疑
シツギョー	シツギョウ、失業
シツケ	しつけ、し付、し付け、仕付、仕付け
シツゲン	しつげん、失言
シツネン	失念
シツボー	失望
シツム	しつむ、執務
シツメイ	失明
シツモン	しつもん、シツモン、質問
シツレイ	失礼
シツレン	しつれん、シツレン、失恋
シツーハッタツ	四通八達
シテイ	してい、し定、指定
シテキ	指摘
シトー	しとう、し闘、死闘、私とう、私闘
シドー	しどう、し動、し導、始動、指どう、指導
シナギレ	品切れ
シナサダメ	品さだめ、品定め
シナン	しなん、し南、指なん、指南
シニン	しにん、し認、視認
シネン	しねん、し念、思念
シハイ	しはい、し配、支配
シハン	しはん、市はん、市販
シバイ	しばい、芝居
シフク	しふく、し伏、雌伏
シフト	シフト
シブンゴレツ	四分五裂
シベツ	しべつ、し別、死別
シベン	しべん、し弁、思弁、支弁
シボ	しぼ、し慕、思ぼ、思慕
シボツ	しぼつ、し没、死歿、死没
シボー	しぼう、し亡、し望、志望、死亡
シマ	揣摩
シマツ	しまつ、し末、始まつ、始末
シミヌキ	しみ抜き、染みぬき、染み抜き、染抜き
シミュレーション	シミュレーション
シミュレート	シミュレート
シメイ	しめい、し名、指名
シメツ	しめつ、し滅、死滅
シモヤケ	しもやけ、シモヤケ、霜やけ、霜焼け
シモン	しもん、し問、試問、諮問
シャ	謝
シャエイ	射影、舎営
シャオン	しゃ音、謝恩、遮音
シャクザイ	借財
シャクネツ	しゃくねつ、しゃく熱、灼熱、赤熱
シャクブク	しゃくぶく、折伏
シャクホー	釈放
シャクメイ	釈明
シャクモン	しゃくもん、借問
シャクヨー	借用
シャクラン	借覧
シャクリョー	酌量
シャケツ	しゃけつ、しゃ血、瀉血
シャケン	しゃけん、シャケン、車検
シャゲキ	しゃげき、射撃
シャコク	社告
シャコー	しゃこう、しゃ光、しゃ口、シャコウ、藉口、遮光
シャサイ	しゃさい、車載
シャサツ	射殺
シャザイ	しゃざい、謝罪
シャシュツ	射出
シャショク	しゃしょく、写植
シャショー	しゃしょう、捨象
シャセイ	しゃせい、写生、射精
シャゼツ	謝絶
シャゾー	写像
シャダン	しゃ断、遮断
シャッキン	しゃっきん、しゃっ金、シャッキン、借金
シャットアウト	シャットアウト
シャフツ	煮沸
シャヘイ	しゃへい、遮へい、遮蔽
シャメン	しゃめん、赦免
シャモン	しゃもん、シャモン、借問
シャヨーカ	斜陽化
シャワー	シャワー
シャンプー	シャンプー
シュエン	しゅえん、シュエン、主演
シュカン	しゅかん、シュカン、主管
シュキ	しゅき、シュキ、手記
シュギョー	しゅぎょう、シュギョウ、修業、修行
シュクエイ	宿営、宿衛
シュクガ	祝賀
シュクガク	粛学
シュクグン	粛軍
シュクゲン	縮減
シュクサツ	縮刷
シュクシャ	しゅくしゃ、シュクシャ、縮写
シュクシャク	縮尺
シュクショー	しゅくしょう、シュクショウ、縮小
シュクセイ	しゅくせい、粛正、粛清
シュクタイ	縮退
シュクダイ	しゅくだい、シュクダイ、宿だい、宿題
シュクチョク	宿直
シュクトー	しゅくとう、しゅく党、祝とう、祝祷、粛とう、粛党
シュクハク	しゅくはく、シュクハク、宿泊
シュクフク	しゅくふく、祝福
シュクボー	宿望
シュコー	しゅこう、手交、首肯
シュゴ	しゅご、シュゴ、守護
シュサイ	しゅさい、シュサイ、主催、主宰
シュザイ	しゅざい、シュザイ、取材
シュシャ	取捨、手写
シュシャセンタク	取捨選択
シュショ	しゅしょ、手書、朱書
シュショー	しゅしょう、シュショウ、主唱、手抄、首唱
シュジュツ	しゅじゅつ、シュジュツ、手術
シュチョー	しゅちょう、しゅ脹、シュチョウ、主張
シュッカ	しゅっか、シュッカ、出か、出火、出荷
シュッカン	しゅっかん、出棺
シュッキョー	しゅっきょう、出郷
シュッキン	しゅっきん、しゅっ勤、出きん、出勤、出金
シュッケ	しゅっけ、出け、出家
シュッケツ	しゅっけつ、シュッケツ、出血
シュッコ	しゅっこ、出庫
シュッコク	しゅっこく、出国
シュッコー	しゅっこう、シュッコウ、出向、出港、出稿、出航
シュッサツ	しゅっさつ、出札
シュッサン	しゅっさん、しゅっ産、シュッサン、出さん、出産
シュッシ	しゅっし、シュッシ、出し、出仕、出資
シュッシャ	しゅっしゃ、出しゃ、出射、出社
シュッショ	しゅっしょ、出所
シュッショー	しゅっしょう、出生
シュッスイ	しゅっすい、しゅっ水、出すい、出水
シュッセ	しゅっせ、出せ、出世
シュッセイ	しゅっせい、シュッセイ、出せい、出征、出精
シュッセキ	しゅっせき、しゅっ席、シュッセキ、出席
シュッセン	しゅっせん、しゅっ船、出せん、出船
シュッソー	しゅっそう、しゅっ走、出そう、出走
シュッタイ	しゅったい、出たい、出来
シュッタツ	しゅったつ、出たつ、出立
シュッタン	しゅったん、しゅっ炭、出たん、出炭
シュッチョー	しゅっちょう、しゅっ張、シュッチョウ、出張
シュッチン	しゅっちん、しゅっ陳、出陳
シュッテイ	しゅってい、しゅっ廷、出てい、出廷
シュッテン	しゅってん、シュッテン、出展、出店
シュットー	しゅっとう、しゅっ頭、出とう、出頭
シュッパツ	しゅっぱつ、シュッパツ、出発
シュッパン	しゅっぱん、シュッパン、出帆、出版
シュッピ	しゅっぴ、出費
シュッピン	しゅっぴん、シュッピン、出品
シュップ	出府
シュッペイ	しゅっぺい、出兵
シュッポン	しゅっぽん、出奔
シュツエン	しゅつえん、出えん、出捐、出演
シュツガ	出芽
シュツガン	シュツガン、出願
シュツギョ	しゅつぎょ、出御、出漁
シュツゲキ	出撃
シュツゲン	しゅつげん、シュツゲン、出現
シュツゴク	出獄
シュツジョー	しゅつじょう、シュツジョウ、出場
シュツジン	出陣
シュツダイ	出題
シュツド	しゅつど、出土
シュツドー	しゅつどう、出動
シュツニュー	出入
シュツバ	出馬
シュツホ	出穂
シュツボツ	出没
シュツライ	しゅつらい、出来
シュツリ	出離
シュツリョク	しゅつりょく、シュツリョク、出力
シュツリョー	しゅつりょう、出漁、出猟
シュツルイ	出るい、出塁
シュツロ	しゅつろ、出ろ、出廬
シュトク	しゅとく、シュトク、取得
シュトー	しゅとう、シュトウ、種痘
シュドー	しゅどう、シュドウ、主導
シュビ	守備
シュベツ	しゅべつ、シュベツ、種別
シュボー	首謀
シュリョー	しゅりょう、狩猟
シュンキョ	しゅんきょ、しゅん拒、峻拒
シュンコー	しゅんこう、しゅん功、しゅん工、竣功、竣工
シュンジュン	しゅんじゅん、しゅん巡、逡巡
シュンセイ	しゅんせい、竣成
シュンセツ	しゅんせつ、浚渫
シュンドー	しゅんどう、しゅん動、蠢動
シュンベツ	しゅんべつ、しゅん別、峻別
シューイ	しゅうい、シュウイ、就位
シューエキ	しゅうえき、シュウエキ、就役
シューエン	しゅうえん、シュウエン、周延、終えん、終演
シューカ	しゅうか、シュウカ、蒐荷、集荷、集貨
シューカイ	しゅうかい、シュウカイ、周回、集会
シューカク	しゅうかく、シュウカク、収穫
シューカン	しゅうかん、シュウカン、収監
シューガク	しゅうがく、シュウガク、修学、就学
シューキン	しゅうきん、シュウキン、集金
シューギョー	しゅうぎょう、シュウギョウ、就業、終業、襲業
シューケイ	しゅうけい、シュウケイ、集計
シューケツ	しゅうけつ、終決、終結、集結
シューゲキ	しゅうげき、襲撃
シューコー	しゅうこう、シュウコウ、修交、修好、周航、就こう、就航
シューゴー	しゅうごう、シュウゴウ、習合、集合
シューサイ	しゅうさい、収載
シューサン	集さん、集散
シューシ	終止
シューシャク	襲爵
シューシュ	しゅうしゅ
シューシュク	しゅうしゅく、収縮
シューシュボーカン	袖手傍観
シューシュー	修習、収拾、収集、蒐集
シューショク	しゅうしょく、シュウショク、修飾、就職、襲職
シューショー	しゅうしょう、シュウショウ、周章、就床
シューシン	しゅうしん、シュウシン、執心、就寝
シュージャク	しゅうじゃく、執着
シュージュ	収受
シュージュク	習熟
シュージョク	しゅうじょく、就じょく、就褥
シューセイ	しゅうせい、シュウセイ、修整、修正、集成
シューセキ	しゅうせき、シュウセキ、集積
シューセン	しゅうせん、周旋、集線
シューゼン	しゅうぜん、シュウゼン、修繕
シューソ	しゅうそ、愁訴
シューソク	収束、終息、終熄、集束
シューゾー	しゅうぞう、シュウゾウ、修造、収蔵
シュータイセイ	シュウタイセイ、集大成
シュータン	しゅうたん、シュウタン、愁嘆、愁歎
シューダツ	収奪
シューチ	周知
シューチク	修築
シューチャク	しゅうちゃく、執着
シューチュー	しゅうちゅう、シュウチュウ、集中
シューテイ	修訂
シュート	シュート
シュートク	しゅうとく、シュウトク、修得、収得、拾得、習得
シュードー	しゅうどう、シュウドウ、修道
シューニン	シュウニン、就任
シューノー	しゅうのう、シュウノウ、収納
シューハイ	集はい、集配
シューバツ	しゅうばつ、修祓
シューフク	しゅうふく、シュウフク、修復
シューフツ	しゅうふつ、修祓
シューホ	しゅうほ、修補
シューミン	シュウミン、就眠
シューメイ	しゅうめい、シュウメイ、襲名
シューヤク	集約
シューユー	周遊
シューヨー	シュウヨウ、修養、収容、収用、襲用
シューライ	しゅうらい、襲来
シューラン	しゅうらん、収らん、収攬
シューリ	しゅうり、シュウリ、修理
シューリョー	しゅうりょう、シュウリョウ、修了、終了、終漁
シューレン	しゅうれん、修練、修錬、収れん、収斂、習れん、習練
シューロク	しゅうろく、シュウロク、収録、集録
シューロー	しゅうろう、シュウロウ、就労
シューワイ	収賄
シユイ	しゆい、思惟
シユー	しゆう、し有、私ゆう、私有
ショ	しょ、処
ショエン	初演
ショカツ	ショカツ、所かつ、所轄
ショカン	しょかん、ショカン、所管
ショキ	しょき、ショキ、庶幾、所期
ショク	しょく、嘱、属
ショクガイ	蝕害、食害
ショクゲン	食言
ショクザイ	しょくざい、しょく罪、贖罪
ショクショー	食傷
ショクシン	触診
ショクジ	しょくじ、ショクジ、植字、食事
ショクジュ	植樹
ショクセツ	触接
ショクタク	しょくたく、ショクタク、嘱託、属託
ショクチュードク	しょくちゅうどく、食中毒
ショクハツ	触発
ショクヒ	植皮
ショクホー	触法
ショクボー	嘱望、属望
ショクミン	植民、殖民
ショクモク	しょくもく、嘱目、属目
ショクモー	植毛
ショクリン	植林
ショグー	処遇
ショケイ	しょけい、処刑
ショケツ	処決
ショケン	しょけん、ショケン、書見
ショシャ	しょしゃ、ショシャ、書写
ショシュツ	初出
ショジ	しょじ、所持
ショゾク	しょぞく、ショゾク、所属
ショゾー	ショゾウ、所蔵
ショダン	処断
ショチ	しょち、処置
ショット	ショット
ショッピング	ショッピング
ショバツ	処罰
ショヒョー	ショヒョウ、書評
ショブン	しょぶん、ショブン、処分
ショホー	しょほう、ショホウ、処方
ショメイ	しょめい、ショメイ、署名
ショモー	しょもう、所望
ショユー	しょゆう、ショユウ、所有
ショヨー	ショヨウ、所要
ショリ	しょり、ショリ、処理
ショー	生、称、証
ショーアイ	しょうあい、しょう愛、鍾愛
ショーアク	掌握
ショーアップ	ショーアップ
ショーアツ	昇圧
ショーイン	しょういん、ショウイン、承引、証印
ショーオン	消音
ショーオー	しょうおう、照応
ショーカ	しょうか、ショウカ、昇か、昇華、消か、消化、消火
ショーカイ	しょうかい、しょう介、しょう会、しょう戒、哨戒、照会、紹介、詳解
ショーカク	しょうかく、ショウカク、昇格
ショーカン	しょうかん、ショウカン、償還、召喚、召還、招かん、招喚
ショーガイ	しょうがい、ショウガイ、傷害、生害
ショーガン	しょうがん、賞がん、賞玩、賞翫
ショーキ	しょうき、詳記
ショーキャク	しょうきゃく、償却、消却、焼却、銷却
ショーキュー	しょうきゅう、昇級、昇給
ショーキョ	ショウキョ、消去
ショーギ	しょうぎ、ショウギ、商議
ショーケイ	しょうけい、ショウケイ、小憩、小計、少憩、憧憬、承継
ショーケツ	しょうけつ、猖獗
ショーゲン	しょうげん、ショウゲン、証言、詳言
ショーコ	しょうこ、ショウコ、称呼
ショーコー	しょうこう、ショウコウ、少考、昇降、消光、消耗、焼こう、焼香
ショーゴン	荘厳
ショーゴー	しょうごう、ショウゴウ、承合、照合
ショーサ	しょうさ、照査
ショーサツ	笑殺
ショーサン	しょうさん、ショウサン、消散、称讚、称賛、賞讚、賞賛
ショーシ	しょうし、焼し、焼死
ショーシツ	しょうしつ、消失、焼失
ショーシャ	しょうしゃ、ショウシャ、照射
ショーシャク	しょうしゃく、焼しゃく、焼灼
ショーシュツ	抄出
ショーシュー	しょうしゅう、ショウシュウ、召集、招集
ショーシン	しょう心、傷心、昇進、焦心、焼身、衝心、陞進
ショージュツ	詳述
ショージュン	照準
ショージョ	しょうじょ、昇叙、陞叙
ショージン	しょうじん、消じん、消尽、焼じん、焼尽、精じん、精進
ショージンケッサイ	精進潔斎
ショースイ	しょうすい、憔悴
ショーセイ	しょうせい、ショウセイ、招請、焼成
ショーセツ	しょうせつ、ショウセツ、詳説
ショーソ	勝訴
ショーソン	焼損
ショーソー	しょうそう、焦そう、焦燥、焦躁
ショータイ	しょうたい、ショウタイ、招待
ショータン	しょうたん、賞嘆
ショーダク	しょうだく、承諾
ショーダン	商談、昇段
ショーチ	しょうち、ショウチ、召致、承知、招致
ショーチョー	しょうちょう、ショウチョウ、消長、象徴
ショーチン	しょうちん、消沈、銷沈
ショーテイ	しょうてい、訟廷
ショーテン	しょうてん、ショウテン、昇天
ショーデン	しょうでん、昇殿
ショート	ショート
ショートツ	しょうとつ、ショウトツ、衝突
ショートリヒキ	商取り引き、商取引、商取引き
ショートー	しょうとう、消とう、消灯
ショードク	しょうどく、ショウドク、消毒
ショードン	焼鈍
ショードー	しょうどう、しょう動、唱導、唱道、聳動、衝動
ショーニン	しょうにん、承認、昇任、陞任
ショーノー	しょうのう、ショウノウ、笑納
ショーハ	しょうは、小は、小破、翔は、翔破
ショーバイ	しょうばい、ショウバイ、商売
ショーバン	しょうばん、ショウバン、相伴
ショーヒ	しょうひ、ショウヒ、消費
ショーヒツ	省筆
ショービ	しょうび、称美、賞美
ショーフク	しょうふく、慴伏、懾伏、承伏、承服
ショーブ	しょうぶ、勝ぶ、勝負
ショーヘイ	しょうへい、招へい、招聘
ショーベツ	小別
ショーベン	しょうべん、ショウベン、小便
ショーボ	ショウボ、召募
ショーボー	しょうぼう、ショウボウ、焼亡
ショーマ	しょうま、ショウマ、消磨
ショーミ	しょうみ、ショウミ、賞味
ショーメイ	しょうめい、ショウメイ、照明、証明
ショーメツ	しょうめつ、消滅、生滅
ショーモー	しょうもう、消耗
ショーヤク	しょうやく、抄訳
ショーヨー	しょうよう、奨揚、慫慂、称揚、賞揚、賞用、逍遥
ショーライ	しょうらい、しょう来、招来、請来
ショーラン	しょうらん、照覧、笑らん、笑覧
ショーリ	しょうり、ショウリ、勝利、捷利、掌理
ショーリツ	しょうりつ、聳立
ショーリャク	しょうりゃく、省略
ショーリョ	焦慮
ショーリョー	しょうりょう、商量、渉猟
ショーレイ	しょうれい、奨励
ショーロク	しょうろく、抄録、詳録
ショーロン	詳論
ショーワ	しょうわ、ショウワ、唱和
シヨー	使用、止揚、私用、試用、飼養
シラク	しらく、刺らく、刺絡
シリゴミ	しりごみ、しり込み、尻ごみ、尻込み、後込み
シリョー	しりょう、し料、し量、思料、思量
シレイ	しれい、し令、使令、司令、指令
シロクロ	しろくろ、白黒
シワク	しわく、思わく、思惑
シワケ	しわけ、し分、し分け、し訳、仕分、仕分け、仕訳
シワヨセ	しわ寄せ、シワ寄せ、皺寄せ
シンアイ	しんあい、シンアイ、信愛
シンイリ	新入り
シンエツ	しんえつ、シンエツ、親閲
シンカ	しんか、シンカ、深化、神化、進化
シンカン	しんかん、シンカン、震かん、震撼
シンガイ	しんがい、侵害、震がい、震駭
シンガク	しんがく、シンガク、進学
シンキ	しんき、振起
シンキイッテン	心機一転
シンキュー	進級
シンキン	しんきん、シンキン、親近
シンギ	しんぎ、シンギ、審議
シンギン	しんぎん、しん吟、シンギン、呻吟
シンク	しんく、シンク、辛く、辛苦
シンクロナイズ	シンクロナイズ
シングン	進軍
シンゲキ	しんげき、進撃
シンゲン	しんげん、進言
シンコキュー	しんこきゅう、深呼吸
シンコク	申告、親告
シンコー	しんこう、侵こう、侵寇、侵攻、信仰、振こう、振興、深耕、進こう、進攻、進航、進行、進講、進貢
シンサ	しんさ、シンサ、審査、診査
シンサイ	しんさい、シンサイ、親祭、親裁
シンサク	しんさく、シンサク、振作、新作
シンサツ	しんさつ、シンサツ、診察
シンシャ	しんしゃ、深謝、親しゃ、親炙
シンシャク	しんしゃく、しん酌、斟酌
シンシュク	しんしゅく、伸縮
シンシュツ	しんしゅつ、しん出、シンシュツ、侵出、浸出、滲出、進出
シンショク	しんしょく、侵蝕、侵食、浸蝕、浸食
シンショー	しんしょう、シンショウ、辛勝
シンジ	しんじ、シンジ、臣事
シンジツ	しんじつ、親じつ、親昵
シンジュ	しんじゅ、親授
シンジュン	しんじゅん、浸潤
シンジュー	しんじゅう、心じゅう、心中、臣じゅう、臣従
シンジョー	しんじょう、進上
シンジン	しんじん、信じん、信心
シンジング	シンジング
シンスイ	しんすい、しん水、シンスイ、心酔、浸水、進水
シンセイ	申請
シンセキ	しんせき、シンセキ、浸せき、浸漬
シンセツ	しんせつ、シンセツ、新設
シンゼン	浸ぜん、浸染、浸漸
シンゾー	しんぞう、シンゾウ、新造
シンタイ	しんたい、シンタイ、進退
シンタク	しんたく、シンタク、信託
シンタツ	申達、進達
シンタン	しんたん、しん炭、シンタン、浸炭、滲炭
シンダン	しんだん、シンダン、診断
シンチク	しんちく、シンチク、新築
シンチュー	しんちゅう、シンチュウ、進駐
シンチョク	しんちょく、シンチョク、進ちょく、進捗
シンチョー	しんちょう、シンチョウ、伸張、伸長、新調
シンチンタイシャ	新陳代謝
シンツー	心痛
シンテイ	しんてい、シンテイ、進呈
シンテン	しんてん、シンテン、伸展、進展
シントー	しんとう、しん透、振盪、浸透、滲透、震とう、震盪、震蕩
シンドク	しんどく、シンドク、真読
シンドー	しんどう、シンドウ、振動、震動
シンニュー	しんにゅう、侵入、浸入、進入
シンニン	しんにん、シンニン、信任、新任、親任
シンパイ	しんぱい、心ぱい、心配、親ぱい、親拝
シンパツ	しんぱつ、進ぱつ、進発
シンパン	しんぱん、侵ぱん、侵犯、審ぱん、審判
シンピョー	しんぴょう、信ぴょう、信憑
シンプク	しんぷく、信ぷく、信伏、信服、心ぷく、心服、臣ぷく、臣服
シンボク	しんぼく、親ぼく、親睦
シンボー	しんぼう、辛ぼう、辛抱
シンポ	しんぽ、進ぽ、進歩
シンポー	しんぽう、信ぽう、信奉
シンモン	しんもん、審問
シンヨー	しんよう、シンヨウ、信用
シンライ	しんらい、シンライ、信頼
シンリ	しんり、シンリ、審理
シンリャク	しんりゃく、侵掠、侵略
シンリョー	しんりょう、シンリョウ、診療
シンリン	しんりん、シンリン、親臨
シンロー	しんろう、心労、辛ろう、辛労
シンワ	しんわ、シンワ、親和
シーギャク	しいぎゃく、しい逆、弑虐、弑逆
シード	シード
シールド	シールド
ジ	持
ジアイ	じあい、自愛、試合
ジイ	じい、自い、自慰
ジエイ	じえい、ジエイ、自営、自衛
ジエン	じえん、ジエン、自演
ジカ	磁化
ジカイ	じかい、自壊、自戒
ジカク	じかく、自覚
ジカダンパン	じかだんぱん、じか談ぱん、じか談判、直談判
ジカツ	じかつ、自活
ジガイ	じがい、自害
ジガク	自学
ジガクジシュー	自学自習
ジガタメ	地固め
ジキ	自棄、自記
ジキショ	直書
ジキソ	じきそ、直訴
ジキソー	じきそう、直奏
ジキダン	直談
ジキトー	じきとう、直答
ジキノー	直納
ジキュー	じきゅう、ジキュウ、持久、自給
ジキュージソク	自給自足
ジキョ	辞去
ジキョー	じきょう、自供
ジキラン	直覧
ジキワ	直話
ジギ	辞儀、辞宜
ジギャク	自虐
ジケイ	じけい、自警
ジケツ	自決
ジゲン	示現
ジコシ	事故し、事故死
ジゴ	耳ご、耳語
ジサク	じさく、ジサク、自作
ジサツ	じさつ、ジサツ、自さつ、自殺
ジサン	じさん、ジサン、持さん、持参、自さん、自讚、自賛
ジザ	じざ、侍ざ、侍坐
ジシツ	じしつ、自失
ジシュ	じしゅ、ジシュ、自首
ジシュク	自粛
ジシュー	じしゅう、ジシュウ、自修、自習
ジショ	じしょ、じ書、ジショ、自書、自署
ジショク	辞職
ジショー	じしょう、自称、自証
ジジ	じじ、自じ、自恃
ジジャク	じじゃく、示寂
ジジョー	じじょう、じ定、治定、自乗
ジジン	じじん、自刃、自尽
ジスイ	じすい、自炊
ジセイ	じせい、じ生、ジセイ、自制、自生、自省、自製
ジセキ	自責
ジセン	じせん、自撰、自薦、自選
ジソ	自訴
ジソク	じそく、ジソク、自足
ジソン	じそん、ジソン、自存
ジゾク	ジゾク、持続
ジゾー	じぞう、ジゾウ、自蔵
ジタイ	辞退
ジタク	支度
ジタツ	じ達、示達
ジチョー	じちょう、自ちょう、自嘲、自重
ジチン	自沈
ジッカン	じっ感、ジッカン、実感
ジッケン	じっけん、じっ験、ジッケン、実けん、実検、実見、実験
ジッコー	じっこう、じっ行、ジッコウ、実行
ジッサク	じっさく、じっ作
ジッシ	じっし、じっ施、ジッシ、実し、実施、実視
ジッシャ	じっしゃ、じっ写、じっ射、実写
ジッシュー	じっしゅう、じっ習、ジッシュウ、実習
ジッショー	じっしょう、ジッショウ、実証
ジッセン	じっせん、じっ践、ジッセン、実せん、実戦、実践
ジッセンキューコー	実践躬行
ジッソク	じっそく、じっ測、実測
ジッソー	じっそう、ジッソウ、実装
ジッヘル	ジッヘル
ジツエン	実演
ジツゲン	じつげん、ジツゲン、実現
ジツザイ	実在
ジツゾン	実存
ジツドー	じつどう、実働
ジツヨー	実用
ジテキ	じてき、自適
ジテン	自てん、自転
ジトク	じとく、自とく、自得
ジナリ	地なり、地鳴り
ジニン	じにん、ジニン、自任、自認、辞任
ジハク	自白
ジバク	じばく、ジバク、自爆
ジフ	自ふ、自負
ジフン	じふん、自ふん、自刎、自噴
ジベン	ジベン、自弁
ジマン	じまん、自まん、自慢
ジメツ	じめつ、自滅
ジモン	じもん、ジモン、自問
ジモンジトー	自問自答
ジャクメツ	寂滅
ジャクヤク	じゃくやく、雀躍
ジャスイ	邪推
ジャスティファイ	ジャスティファイ
ジャッカ	じゃっか、弱化
ジャッキ	じゃっき、じゃっ起、惹起
ジャッグル	ジャッグル
ジャッジ	ジャッジ
ジャマ	じゃま、邪魔
ジャンプ	ジャンプ
ジュカイ	じゅかい、受戒、授戒
ジュキュー	ジュキュウ、受給
ジュギョー	じゅぎょう、ジュギョウ、受業、授業
ジュク	じゅく、ジュク、熟
ジュクギ	熟議
ジュクシ	じゅくし、熟思、熟視
ジュクスイ	じゅくすい、熟睡
ジュクセイ	じゅくせい、熟成
ジュクタツ	熟達
ジュクダン	熟談
ジュクチ	熟知
ジュクドク	熟読
ジュクミン	熟眠
ジュクラン	熟覧
ジュクリョ	熟慮
ジュクレン	熟練
ジュクン	じゅくん、ジュクン、受勲
ジュケイ	じゅけい、ジュケイ、受刑
ジュケン	じゅけん、受けん、受検、受験
ジュコー	じゅこう、ジュコウ、受光、受講
ジュショー	じゅしょう、受傷、受賞、授賞
ジュシン	じゅしん、ジュシン、受信、受審、受診
ジュジュ	じゅじゅ、ジュジュ、授受
ジュスイ	じゅすい、入水
ジュセイ	じゅせい、受精、授精
ジュセン	じゅせん、受洗
ジュゼン	受禅
ジュソ	じゅそ、呪詛
ジュソーシン	受送信
ジュゾー	受像、受贈
ジュタイ	受胎
ジュタク	ジュタク、受託
ジュダイ	じゅだい、入内
ジュダク	受諾
ジュチュー	ジュチュウ、受注、受註
ジュッカイ	じゅっかい、述懐
ジュッコー	じゅっこう、熟考
ジュッサク	じゅっさく、述作
ジュッペイ	じゅっぺい、恤兵
ジュデン	受電
ジュナン	ジュナン、受難
ジュニュー	授乳
ジュニン	受任、受忍
ジュノー	ジュノウ、受納
ジュハイ	じゅはい、受配
ジュハッシン	受・発信、受発信
ジュハッチュー	受発注
ジュバク	じゅばく、じゅ縛、呪縛
ジュフン	じゅふん、受粉
ジュメイ	受命
ジュヨ	じゅよ、ジュヨ、授与
ジュヨー	じゅよう、ジュヨウ、受容、受用
ジュライ	じゅらい
ジュラク	じゅらく、入洛
ジュリ	じゅり、ジュリ、受理
ジュリツ	樹立
ジュリョー	じゅりょう、受領
ジュンエツ	巡閲
ジュンエン	巡演、順延
ジュンオー	じゅんおう、順応
ジュンカ	じゅんか、じゅん化、純か、純化、醇化、順か、順化、馴化
ジュンカイ	じゅんかい、ジュンカイ、巡回
ジュンカン	じゅんかん、ジュンカン、循環
ジュンキョ	準拠
ジュンキョー	じゅんきょう、殉教
ジュンギョー	巡業
ジュンケン	じゅんけん、巡検、巡見
ジュンコー	じゅんこう、巡幸、巡航、巡行、順行
ジュンサツ	巡察
ジュンシ	じゅんし、ジュンシ、巡視、殉死
ジュンシャク	じゅんしゃく、巡しゃく
ジュンシュ	じゅんしゅ、ジュンシュ、遵守、順守
ジュンショク	殉職、潤色
ジュンセツ	順接
ジュンチ	じゅんち、馴致
ジュントーガチ	順当勝ち
ジュンノー	じゅんのう、順応
ジュンパイ	じゅんぱい、巡ぱい、巡拝
ジュンビ	じゅんび、ジュンビ、準備
ジュンポー	じゅんぽう、遵ぽう、遵奉
ジュンユー	じゅんゆう、巡遊
ジュンヨー	じゅんよう、準用
ジュンラ	じゅんら、巡ら、巡邏
ジュンラン	巡覧
ジュンレイ	じゅんれい、ジュンレイ、巡礼、順礼
ジュンレキ	巡歴
ジューイツ	じゅういつ、充いつ、充溢
ジューイン	じゅういん、充員
ジューカン	じゅうかん、縦貫
ジューギョー	従業
ジューグン	従軍
ジューケツ	じゅうけつ、充血
ジューゲキ	銃撃
ジューコク	重刻
ジューコン	じゅうこん、重婚
ジューゴー	じゅうごう、重合
ジューサツ	重刷、銃殺
ジューシ	じゅうし、ジュウシ、重視
ジューシュツ	重出
ジューショー	じゅうしょう、ジュウショウ、重唱
ジュージ	じゅうじ、ジュウジ、従事
ジュージツ	じゅうじつ、ジュウジツ、充実
ジューソ	じゅうそ、重そ、重祚
ジューソク	じゅうそく、充そく、充塞、充足
ジューソー	じゅうそう、ジュウソウ、縦走、重奏
ジューゾク	従属、縦続
ジュータイ	じゅうたい、ジュウタイ、渋滞
ジューダン	じゅうだん、縦断
ジューテイ	じゅうてい、重訂
ジューテン	じゅうてん、充てん、充填
ジューデン	じゅうでん、充電
ジュートー	じゅうとう、充当
ジューニン	じゅうにん、重任
ジューハン	じゅうはん、重版
ジューフク	じゅうふく、重複
ジューマン	じゅうまん、充満
ジューヤク	じゅうやく、重訳
ジューヨー	じゅうよう、ジュウヨウ、充用、重用
ジューラン	じゅうらん、縦覧
ジューリン	じゅうりん、蹂躙
ジョ	叙、序、恕、除
ジョイント	ジョイント
ジョエン	じょえん、助演
ジョガイ	除外
ジョキョ	じょきょ、ジョキョ、除去
ジョクン	叙勲
ジョゲン	じょげん、助言
ジョコー	じょこう、徐行
ジョゴン	助言
ジョザン	除算
ジョジュツ	叙述
ジョセイ	じょせい、助勢、助成
ジョセキ	除籍
ジョセツ	じょせつ、叙説、絮説、除雪
ジョソー	じょそう、助そう、助奏、助走、女そう、女装、除草
ジョタイ	じょたい、除隊
ジョチョー	じょちょう、助長
ジョデン	除電
ジョニン	叙任
ジョフク	じょふく、除服
ジョメイ	じょめい、じょ命、助命、除名
ジョリョク	じょりょく、じょ力、助力
ジョーイ	じょうい、ジョウイ、譲位
ジョーエイ	じょうえい、上映
ジョーエン	じょうえん、上演
ジョーカ	じょうか、ジョウカ、浄化
ジョーカン	じょうかん、ジョウカン、乗艦
ジョーキ	じょうき、ジョウキ、上き、上気
ジョーキョー	じょうきょう、ジョウキョウ、上京
ジョーキン	じょうきん、ジョウキン、常勤
ジョーゲ	じょうげ、ジョウゲ、上下
ジョーコク	じょうこく、上告
ジョーコー	じょうこう、ジョウコウ、乗降
ジョーサン	じょうさん、蒸散
ジョーザン	じょうざん、乗算
ジョーシ	じょうし、上し、上梓、情死
ジョーシャ	じょうしゃ、ジョウシャ、乗車、浄写
ジョーショ	じょうしょ、上書、浄書
ジョーショク	常食
ジョーショー	じょうしょう、ジョウショウ、上昇
ジョーシン	じょうしん、ジョウシン、上申
ジョージュ	じょうじゅ、ジョウジュ、成就
ジョージュツ	上述
ジョージュー	常住
ジョージョ	乗除
ジョージョー	じょうじょう、ジョウジョウ、上じょう、上場
ジョースイ	じょうすい、ジョウスイ、浄水
ジョーセイ	じょうせい、ジョウセイ、醸成
ジョーセツ	常設
ジョーセン	じょうせん、ジョウセン、上船、乗せん、乗船
ジョーソ	上そ、上訴
ジョーソー	じょうそう、ジョウソウ、上そう、上奏
ジョーゾク	じょうぞく、上ぞく、上蔟
ジョーゾー	じょうぞう、醸造
ジョータツ	じょうたつ、上達
ジョーチ	じょうち、ジョウチ、常置
ジョーチャク	蒸着
ジョーチュー	じょうちゅう、ジョウチュウ、常駐
ジョーチョク	常直
ジョーテイ	じょうてい、上程
ジョート	じょうと、ジョウト、譲渡
ジョードー	じょうどう、成道
ジョーニン	じょうにん、ジョウニン、常任
ジョーノー	じょうのう、上のう、上納
ジョーハ	じょうは、条は、条播
ジョーハツ	じょうはつ、蒸発
ジョーバ	じょうば、ジョウバ、乗馬
ジョービ	じょうび、ジョウビ、常備
ジョーブツ	じょうぶつ、成仏
ジョーホ	じょうほ、譲歩
ジョーボク	上木
ジョーム	ジョウム、乗務
ジョーヨ	じょうよ、譲与
ジョーヨー	じょうよう、常よう、常傭、常用
ジョーラク	じょうらく、上洛
ジョーラン	じょうらん、じょう乱、上覧、擾乱
ジョーリク	じょうりく、上陸
ジョーリュー	じょうりゅう、蒸りゅう、蒸溜、蒸留
ジリツ	じりつ、侍立、自律、自立
ジンスイ	じんすい、尽すい、尽瘁
ジンセン	じんせん、ジンセン、人せん、人選
ジンボツ	陣歿、陣没
ジンモン	じんもん、尋問、訊問
ジンリョク	じんりょく、じん力、尽力
スイイ	すいい、推移
スイエイ	すいえい、水泳
スイカ	すいか、すい何、スイカ、垂下、誰何
スイキョ	推挙
スイケイ	すいけい、推計
スイコー	すいこう、推こう、推敲、推考、遂行
スイサツ	推察
スイサン	すいさん、推さん、推参、推算、炊さん、炊爨
スイサンカ	水酸化
スイシ	すいし、垂死、垂示、水死
スイショ	水書
スイショク	すいしょく、水蝕、水食
スイショー	すいしょう、推奨、推称、推賞
スイシン	すいしん、推進
スイジ	すいじ、炊事
スイジャク	すいじゃく、衰弱
スイセン	推薦、推選、水洗
スイゼン	すいぜん、垂ぜん、垂涎
スイソク	すいそく、推測
スイソー	すいそう、吹奏、水葬
スイタイ	すいたい、推たい、推戴、衰たい、衰退、衰頽
スイダン	推断
スイチ	すいち、推知
スイチョー	すいちょう、推重
スイッチ	スイッチ
スイッチング	スイッチング
スイテイ	すいてい、推定
スイトー	すいとう、出納
スイナン	水なん、水難
スイハン	すいはん、垂範
スイバン	すいばん、推ばん、推挽、推輓
スイビ	すいび、衰微
スイフク	推服
スイボツ	水没
スイボー	すいぼう、衰亡
スイミン	すいみん、スイミン、睡眠
スイメイ	すいめい、吹鳴
スイメツ	衰滅
スイヨク	すいよく、水よく、水浴
スイリ	すいり、推理
スイリョー	すいりょう、推量
スイロン	推論
スイング	スイング
スエツケ	すえ付、すえ付け、据え付、据え付け、据付
スカウト	スカウト
スキップ	スキップ
スキャン	スキャン
スクリーニング	スクリーニング
スクロール	スクロール
スクープ	スクープ
スケッチ	スケッチ
スタート	スタート
スチール	スチール
ステッチ	ステッチ
ストア	ストア
ストック	ストック
ストップ	ストップ
ストライキ	ストライキ
ストレートガチ	ストレート勝ち
スドーリ	すどおり、素通り
スナップ	スナップ
スパイク	スパイク
スパッタジョーチャク	スパッタ蒸着
スパッタリング	スパッタリング
スパーク	スパーク
スパート	スパート
スパーリング	スパーリング
スピン	スピン
スピーチ	スピーチ
スピードアップ	スピードアップ
スポイル	スポイル
スマッシュ	スマッシュ
スマッシング	スマッシング
スライス	スライス
スライディング	スライディング
スライド	スライド
スリップ	スリップ
スンダン	すんだん、寸断
スンピョー	すんぴょう、寸ぴょう、寸評
スンレツ	寸裂
スーケイ	すうけい、崇敬
スーハイ	すうはい、崇拝
ズイキ	ずいき、随喜
ズイコー	ずいこう、随行
ズイジュン	随順
ズイジュー	随従
ズイジン	随身
ズイハン	随伴
ズカイ	ずかい、ズカイ、図解
ズシ	図し、図示
ズセツ	ズセツ、図説
ズーム	ズーム
ズームアップ	ズームアップ
セイ	制、征
セイアツ	せいあつ、制圧
セイイク	せいいく、セイイク、成育、生育
セイエン	せいえん、セイエン、声援、製塩
セイカイ	せいかい、セイカイ、正解
セイカク	製革
セイカツ	せいかつ、せい活、セイカツ、生かつ、生活
セイカン	せいかん、生還、静観
セイガン	せいがん、セイガン、請願
セイキ	せいき、セイキ、生き、生起
セイキュー	せいきゅう、セイキュウ、請求
セイキョ	せいきょ、逝去
セイキン	せいきん、精勤
セイギョ	せいぎょ、セイギョ、制御、制禦、制馭
セイギョー	成業
セイクン	せいくん、請訓
セイケイ	せいけい、セイケイ、成型、成形、整形
セイゲン	せいげん、セイゲン、制限、誓言
セイコン	せいこん、成婚
セイコー	せいこう、セイコウ、性こう、性交、成功、盛行、製鋼
セイコーイ	性行為
セイコーウドク	せいこううどく、晴耕雨読
セイゴ	せいご、正誤
セイゴン	誓言
セイゴー	せいごう、セイゴウ、整合
セイサ	せいさ、セイサ、精査
セイサイ	せいさい、制裁
セイサク	せいさく、セイサク、制作、製作
セイサツ	せいさつ、省察、精察
セイサン	清算、生産、精算
セイザ	せいざ、セイザ、正坐、正座、静坐、静座
セイザイ	せいざい、セイザイ、製材
セイシ	制し、制シ、制止、正し、正シ、正視、静し、静思、静止
セイショ	せいしょ、セイショ、清書
セイショク	せいしょく、セイショク、生殖、生食
セイショー	せいしょう、セイショウ、斉唱
セイジュク	せいじゅく、成熟
セイジョ	せいじょ、整除
セイジョー	せいじょう、清浄
セイジン	せいじん、せい人、セイジン、成人
セイズ	せいず、セイズ、製図
セイセイ	せいせい、清々、清せい、清清、生せい、生成、精製
セイセン	せいせん、セイセン、精選
セイゼン	せいぜん、西漸
セイソク	せいそく、せい息、栖息、棲息、生息
セイソー	せいそう、正そう、正装、清そう、清掃、盛そう、盛装
セイゾロイ	勢ぞろい、勢揃い
セイゾン	せいぞん、生存
セイゾー	せいぞう、セイゾウ、製造
セイタイ	せいたい、セイタイ、整体
セイタク	請托、請託
セイタン	せいたん、セイタン、生誕
セイダン	せいだん、政談
セイチ	せいち、整地
セイチュー	せいちゅう、掣肘
セイチョー	せいちょう、セイチョウ、成長、清聴、生長、静聴
セイツー	せいつう、精通
セイテイ	せいてい、セイテイ、制定
セイテツ	せいてつ、製鉄
セイトン	せいとん、整とん、整頓
セイトー	せいとう、セイトウ、征討、正答、製糖
セイドク	精読
セイドー	せいどう、セイドウ、制動、生動
セイハ	せいは、せい覇、制は、制覇
セイハク	せいはく、精白
セイハツ	整髪
セイハン	せいはん、製版
セイバイ	せいばい、成ばい、成敗
セイバツ	せいばつ、征伐
セイヒョー	製氷、製表
セイビ	せいび、セイビ、整備
セイフク	せいふく、セイフク、征服、整復
セイフン	製粉
セイベツ	せいべつ、セイベツ、生別
セイホン	セイホン、製本
セイマイ	せいまい、精米
セイメイ	せいめい、セイメイ、声明、清明
セイヤク	せいやく、セイヤク、制約、成約、誓約
セイユ	せいゆ、セイユ、精油、製油
セイユー	せいゆう、セイユウ、清遊、西ゆう、西遊
セイヨク	せいよく、制慾、制欲
セイヨー	せいよう、セイヨウ、静養
セイリ	せいり、セイリ、整理
セイリツ	せいりつ、セイリツ、成立
セイリャク	せいりゃく
セイリュー	せいりゅう、セイリュウ、整流
セイレイ	せいれい、セイレイ、精励
セイレツ	せいれつ、せい列、整れつ、整列
セイレン	せいれん、セイレン、精煉、精練、精錬
セキサイ	せきさい、積載
セキサン	せきさん、セキサン、積算
セキシュツ	析出
セキソー	せきそう、積層
セキネツ	赤熱
セキハイ	惜敗
セキブン	せきぶん、セキブン、積分
セキベツ	惜別
セキメン	せきめん、赤面
セギョー	せぎょう、せ行、施行
セコー	せこう、せ工、せ行、セコウ、施工、施行
セシュー	世襲
セジョー	施錠
セッ	せっ、接
セッカ	せっか、赤っか、赤化
セッカイ	せっかい、切開
セッカン	せっかん、切諌、折檻
セッキャク	せっきゃく、接客
セッキョー	せっきょう、説教、説経
セッキン	せっきん、せっ近、接近
セックス	セックス
セッケイ	せっけい、せっ計、設計
セッケン	せっけん、せっ倹、せっ見、席巻、席捲、接見、節倹
セッサ	せっさ、切さ、切磋
セッサク	せっさく、切削
セッサタクマ	せっさたくま、切磋琢磨
セッシャ	せっしゃ、接写
セッシュ	せっしゅ、接種、摂取、窃取、節酒
セッシュー	せっしゅう、接収
セッショク	せっしょく、接触、節食
セッショー	せっしょう、折衝、殺生
セッスイ	せっすい、せっ水、節水
セッセイ	せっせい、摂生、節制
セッセン	せっせん、接戦
セッソン	折損
セッタイ	せったい、接待
セッチ	せっち、せっ着、せっ置、接地、設置
セッチャク	せっちゃく、接着
セッチュー	せっちゅう、折中、折衷
セッテイ	せってい、せっ定、設定
セット	セット
セットク	せっとく、説得
セットー	せっとう、せっ盗、接頭、窃盗
セッパ	せっぱ、説破
セッパク	せっぱく、切迫
セッパン	せっぱん、折半、接伴
セップク	せっぷく、切腹、説伏
セップン	せっぷん、接吻
セッポー	せっぽう、説法
セツエイ	設営
セツエン	せつえん、せつ煙、節煙、雪えん、雪冤
セツガン	切願、接がん、接岸
セツゲン	せつげん、切言、節減
セツゴー	せつごう、接合
セツジ	せつじ、説示
セツジュ	接受
セツジョ	切除
セツジョク	雪辱
セツゼイ	節税
セツゾク	せつぞく、セツゾク、接続
セツダン	せつだん、セツダン、切断、截断
セツデン	節電
セツドー	せつどう、摂動
セツビ	せつび、セツビ、接尾、設備
セツボー	切望
セツマイ	節米
セツメイ	せつめい、せつ明、セツメイ、説明
セツモン	せつもん、設問
セツヤク	せつやく、セツヤク、節約
セツユ	せつゆ、説諭
セツリツ	せつりつ、セツリツ、設立
セツリャク	節略
セツロク	節録
セツロン	切論
セノビ	せのび、背のび、背伸び
セヒ	せひ、施肥
セマイ	施米
セヨ	施与
セリョー	せりょう、施療
セレクト	セレクト
セワ	せわ、せ話、世わ、世話
セン	宣、撰
センイ	せんい、センイ、遷移
センエン	せんえん、センエン、遷延
センカ	せんか、センカ、選歌
センカイ	せんかい、旋回
センカン	せんかん、センカン、専管
センガン	せんがん、センガン、洗眼、洗顔
センキョ	せんきょ、センキョ、占居、占拠、選挙
センキョク	センキョク、選曲
センキョー	せんきょう、センキョウ、宣教
センギ	せんぎ、せん議、先議、詮議
センク	せんく、センク、先駆、選句
センケツ	せんけつ、先決、専決
センケン	せんけん、センケン、先遣
センゲ	せんげ、宣げ、宣下、遷げ、遷化
センゲン	せんげん、センゲン、宣言
センコク	せんこく、宣告
センコー	せんこう、せん孔、先攻、先行、専攻、専行、潜幸、潜航、潜行、穿孔、遷幸、選好、選考、選鉱、銓衡
センゴ	せんご、センゴ、先後
センサク	せんさく、せん索、穿鑿、詮索
センザ	せんざ、遷座
センザイ	せんざい、センザイ、潜在
センシ	せんし、センシ、戦死
センシュ	先取
センシュツ	選出
センシュー	せんしゅう、せん修、専修、撰修
センショク	せんしょく、センショク、染色
センショー	せんしょう、僭称、先勝、戦勝、戦捷、選奨
センシン	せんしん、センシン、専心、潜心
センジュツ	せんじゅつ、先述、撰述
センジュー	せんじゅう、専従
センジョー	せんじょう、せん情、センジョウ、扇情、洗じょう、洗浄、洗滌、煽情
センスイ	せんすい、せん水、センスイ、潜水
センセイ	先制、宣誓
センセン	せんせん、センセン、先占、宣戦
センゼイ	せんぜい、占ぜい、占筮、蝉ぜい、蝉蛻
センソ	せんそ、践そ、践祚
センソー	せんそう、センソウ、戦争
センゾク	せんぞく、センゾク、専属
センタク	せんたく、センタク、洗たく、洗濯、選たく、選択
センタリング	センタリング
センタン	せんたん、センタン、選炭
センダツ	せんだつ、先達、蝉脱
センダン	せん断、専断、擅断
センチャク	せんちゃく、先着
センテイ	せんてい、せん定、剪定、選定
センテン	せんてん、センテン、旋転
センデキ	せんでき、洗滌
センデン	せんでん、センデン、宣伝
セント	せんと、遷都
セントー	戦闘
センドー	せんどう、せん動、先導、扇動、煽動、顫動
センニュー	せんにゅう、センニュウ、潜入
センニン	せんにん、センニン、専任、選任
センネン	せんねん、センネン、専念
センノー	せんのう、センノウ、洗脳
センバツ	せんばつ、選抜
センパツ	せんぱつ、せん発、せん髪、先ぱつ、先発、染ぱつ、染髪、洗ぱつ、洗髪
センビョーシ	戦病死
センピツ	せんぴつ、染ぴつ、染筆
センピョー	せんぴょう、選ぴょう、選評
センブ	せんぶ、宣ぶ、宣撫
センブン	せんぶん、せん文、撰文
センプ	せんぷ、宣ぷ、宣布
センプク	せんぷく、潜ぷく、潜伏
センベツ	せんべつ、せん別、選別
センペンバンカ	千変万化
センボツ	戦歿、戦没、潜没
センボー	せんぼう、せん望、羨望
センメイ	せんめい、せん明、闡明
センメツ	せんめつ、せん滅、殲滅
センメン	せんめん、洗面
センユー	せんゆう、センユウ、占有、専有
センヨー	せんよう、せん用、センヨウ、宣揚、専用
センリツ	せんりつ、戦りつ、戦慄
センリョー	せんりょう、占領
センレイ	せんれい、洗礼
センレン	せんれん、洗煉、洗練
セーブ	セーブ
セールス	セールス
ゼイゲン	ぜいげん、ぜい言、贅言
ゼセイ	是正
ゼッ	絶
ゼッキョー	ぜっきょう、絶叫
ゼック	ぜっく、ゼック、絶句
ゼッケ	ぜっけ、ゼッケ、絶家
ゼッコー	ぜっこう、絶交
ゼッサン	ぜっさん、絶讚、絶賛
ゼッショク	ぜっしょく、ぜっ食、絶食
ゼッソク	ぜっそく、絶息
ゼットー	ぜっとう
ゼッパン	ぜっぱん、絶版
ゼッピツ	絶筆
ゼツエン	ぜつえん、絶えん、絶縁
ゼツボー	ぜつぼう、ゼツボウ、絶望
ゼツメイ	ぜつめい、絶命
ゼツメツ	ぜつめつ、絶滅
ゼニン	是認
ゼネスト	ゼネスト
ゼヒ	是非
ゼンカイ	ぜんかい、ゼンカイ、全壊、全快、全潰、全開
ゼンカン	ぜんかん、善感
ゼンキ	ぜんき、ゼンキ、前き、前記
ゼンキュー	ぜんきゅう、全休
ゼンキン	ぜんきん、漸近
ゼンク	ぜんく、前く、前駆
ゼンゲン	ぜんげん、漸減
ゼンゴ	ぜんご、ゼンゴ、前ご、前後
ゼンシャク	前借
ゼンショ	ぜんしょ、ゼンショ、善処
ゼンショー	ぜんしょう、ゼンショウ、全勝、全焼
ゼンシン	ぜんしん、ゼンシン、前進、漸進
ゼンジュツ	前述
ゼンセン	ぜんせん、ゼンセン、善戦
ゼンゾー	ぜんぞう、ゼンゾウ、漸増
ゼンチ	ぜんち、全治
ゼンツー	ぜんつう、全通
ゼントー	ぜんとう、漸騰
ゼンドー	ぜんどう、ぜん動、ゼンドウ、善導、蠕動
ゼンノー	ぜんのう、全納、前のう、前納
ゼンパイ	ぜんぱい、全ぱい、全廃、全敗
ゼンメツ	ぜんめつ、全滅
ゼンヤク	全訳
ゼンユ	ぜんゆ、全ゆ、全癒
ゼンヨー	ぜんよう、善用
ゼンラク	ぜんらく、漸落
ソイネ	そいね、そい寝、添い寝
ソウジョー	騒じょう
ソカイ	そかい、ソカイ、疎開
ソカク	そかく、疎隔、組閣、阻隔
ソガイ	そがい、ソガイ、疎外、阻害、阻碍
ソガン	そがん、ソガン、訴願
ソキュー	そきゅう、そ及、そ求、溯及、訴求、遡及
ソク	即
ソクイ	そくい、即い、即位
ソクエイ	即詠
ソクオー	即応
ソクガ	そくが、側が、側臥
ソクギン	即吟
ソクゲン	そくげん、塞源
ソクシ	そくし、即死
ソクシャ	速写、速射
ソクシン	そくしん、ソクシン、促進
ソクセイ	そくせい、促成、即製、速成
ソクダク	即諾
ソクダン	そくだん、即断、速断
ソクチ	そくち、測地
ソクテイ	そくてい、ソクテイ、測定
ソクトー	そくとう、即答、速答
ソクノー	即納
ソクハツ	即発
ソクバイ	即売
ソクバク	そくばく、ソクバク、束縛
ソクブン	そくぶん、そく聞、仄聞、側聞
ソクホー	そくほう、ソクホウ、速報
ソクリョー	そくりょう、ソクリョウ、測量
ソゲキ	そげき、そ撃、狙撃
ソゲン	そげん、溯源、遡源
ソコイレ	底入れ
ソコビエ	底冷え
ソコー	そこう、そ航、そ行、溯江、溯行、遡江、遡行
ソゴ	そご、ソゴ、齟齬
ソサイ	そさい、阻さい、阻細
ソシ	そし、ソシ、沮止、阻止
ソシキ	そしき、ソシキ、組織
ソシャク	そしゃく、ソシャク、咀しゃく、咀嚼、租借
ソショク	そしょく、粗食
ソショー	そしょう、ソショウ、訴訟
ソジュツ	祖述
ソジョー	溯上、遡上
ソセイ	そせい、そ成、そ生、ソセイ、甦生、組成、蘇生
ソソー	そそう、そ相、ソソウ、沮喪、粗そう、粗相、阻喪
ソチ	措置
ソッキ	そっき、ソッキ、速き、速記
ソッキョ	そっきょ、卒去
ソッケツ	そっけつ、即決、速決
ソッコー	そっこう、ソッコウ、即行、速攻
ソッセン	そっせん、率先
ソットー	そっとう、卒倒
ソツイ	訴追
ソツギョー	そつぎょう、ソツギョウ、卒業
ソツドク	卒読
ソツー	そつう、そ通、疎通、疏通
ソテイ	そてい、ソテイ、措定
ソドク	素読
ソニン	そにん、ソニン、訴人
ソビョー	そびょう、粗描、素描
ソフィスティケート	ソフィスティケート
ソメモノ	そめもの、染めもの、染め物、染物
ソライ	そらい、そ来、徂来
ソン	そん、存
ソンカイ	そんかい、損壊
ソンガイ	そんがい、ソンガイ、損害
ソンキョ	そんきょ、蹲踞
ソンケイ	そんけい、ソンケイ、尊敬
ソンコー	そんこう、損耗
ソンザイ	そんざい、ソンザイ、存在
ソンシツ	そんしつ、ソンシツ、損失
ソンショー	そんしょう、ソンショウ、損傷
ソンシン	そんしん、尊信
ソンスー	尊崇
ソンゾク	そんぞく、存続
ソンタク	そんたく、そん度、忖度
ソンチ	そんち、存置
ソンチョー	そんちょう、ソンチョウ、尊重
ソンモー	そんもう、損耗
ソンリツ	そんりつ、存立
ソー	奏
ソーアイ	そうあい、相愛
ソーアン	そうあん、創案
ソーイ	相違
ソーイン	そういん、ソウイン、掃引
ソーオー	相応
ソーカ	そうか、ソウカ、掃過、装荷
ソーカイ	掃海
ソーカツ	そうかつ、ソウカツ、綜括、綜轄、総括、総轄
ソーカン	そうかん、創かん、創刊、相かん、相姦、相関、送かん、送還
ソーガク	そうがく、ソウガク、奏楽
ソーキ	そうき、ソウキ、想起
ソーキュー	そうきゅう、送球
ソーキン	そうきん、送金
ソーギョー	そうぎょう、ソウギョウ、創業、操業
ソーグー	そうぐう、ソウグウ、遭遇
ソーケイ	そうけい、ソウケイ、総計
ソーケッサン	そうけっさん、総けっ算、総決算
ソーケン	そうけん、ソウケン、創建、想見、総見、送検
ソーゲイ	そうげい、ソウゲイ、送迎
ソーコク	そうこく、相克、相剋
ソーコン	そうこん、早婚
ソーコー	そうこう、奏功、奏効、走行
ソーゴ	そうご、ソウゴ、壮語
ソーゴー	そうごう、ソウゴウ、綜合、総合
ソーサ	そうさ、そう作、ソウサ、捜さ、捜査、操作、走さ、走査
ソーサイ	そうさい、ソウサイ、相殺
ソーサク	そうさく、ソウサク、創作、捜索
ソーサツ	そうさつ、相殺
ソーザン	そうざん、早ざん、早産
ソーシ	そうし、創し、創始、繰糸
ソーシツ	そう失、喪失
ソーシャ	そうしゃ、掃射、操車
ソーシュツ	ソウシュツ、創出、早出、送出
ソーショク	そうしょく、ソウショク、草食、装飾
ソーショー	そうしょう、ソウショウ、総称
ソーシン	喪心、喪神、送信
ソージ	そうじ、ソウジ、掃除、相似
ソージュ	そうじゅ、送受
ソージュー	そうじゅう、操縦
ソージョー	そうじょう、奏上、相じょう、相乗、騒じょう、騒擾
ソースイ	そうすい、送水
ソーセイ	そうせい、そう世、そう生、そう製、ソウセイ、創成、創製、叢生、奏請、早世、簇生
ソーセキ	そうせき、送籍
ソーセツ	そうせつ、ソウセツ、創設、総説
ソーゾク	そうぞく、ソウゾク、相続
ソーゾー	そうぞう、ソウゾウ、創造、想像、送像
ソータイ	そうたい、ソウタイ、早退
ソータツ	送達
ソーダ	そうだ、操だ、操舵
ソーダツ	そうだつ、ソウダツ、争奪
ソーダン	そうだん、ソウダン、相談、装弾
ソーチ	そうち、ソウチ、装置、送致
ソーチャク	そうちゃく、ソウチャク、早着、装着
ソーテイ	想定、装丁、装幀、装釘、送呈
ソーテン	そうてん、装てん、装填
ソーデン	そうでん、相伝、送電
ソートー	争闘、勦討、想到、掃蕩、掃討
ソードー	そうどう、ソウドウ、騒動
ソーナン	そうなん、ソウナン、遭難
ソーニュー	そうにゅう、そう入、挿入
ソーハ	そうは、ソウハ、争覇、走破、送波
ソーハイ	そうはい、送配
ソーハツ	そうはつ、創発
ソーハン	そうはん、相反
ソービ	そうび、ソウビ、装備
ソーフ	そうふ、ソウフ、送付、送附
ソーフー	そうふう、送風
ソーベツ	送別
ソーホ	そうほ、相補
ソーボー	そうぼう、想望
ソーメツ	剿滅、掃滅
ソーモン	そうもん、そう聞、奏聞
ソーユー	そうゆう、そう遊
ソーヨー	そうよう、ソウヨウ、装用
ソーラン	そうらん、奏覧、綜覧、総らん、総攬、総覧
ソーリツ	そうりつ、ソウリツ、創りつ、創立
ソーロン	そうろん、ソウロン、争論
ソーワ	そうわ、そう話、ソウワ、総和、送話
ソーワケ	そうわけ、層分け
ゾク	属
ゾクエイ	続映
ゾクエン	続演
ゾクサイ	続載
ゾクシュツ	ぞくしゅつ、続出
ゾクシン	ぞくしん、続伸
ゾクセイ	ぞくせい、ぞく生、ゾクセイ、族生、簇生、続生
ゾクトー	ぞくとう、続騰
ゾクハツ	続発
ゾクホー	続報
ゾクラク	続落
ゾッカ	ぞっか、俗化
ゾッカン	ぞっかん
ゾッコー	ぞっこう、続行
ゾンチ	ぞんち、存知
ゾンメイ	存命
ゾー	蔵
ゾーアク	増悪
ゾーイ	ぞうい、ゾウイ、贈位
ゾーイン	ぞういん、増員
ゾーエイ	ぞうえい、造営、造影
ゾーエキ	増益
ゾーエン	ぞうえん、ゾウエン、増えん、増援、造園
ゾーオ	ぞうお、憎悪
ゾーカ	ぞうか、増か、増加
ゾーカン	ぞうかん、ゾウカン、増刊、贈官、造艦
ゾーガク	増額
ゾーガン	ぞうがん、象がん、象嵌、象眼
ゾーキュー	増給
ゾーキョー	ぞうきょう、ゾウキョウ、増強
ゾーケイ	ぞうけい、ゾウケイ、造けい、造型、造形
ゾーケツ	増結、造血
ゾーゲン	ぞうげん、増減
ゾーゴ	ぞうご、造語
ゾーゴン	ぞうごん、雑言
ゾーゴー	贈号
ゾーサク	ぞうさく、増作、造作
ゾーサツ	増刷
ゾーサン	ぞうさん、ゾウサン、増産
ゾーシ	ぞうし、増し、増資
ゾーシャ	増車
ゾーシュー	増収
ゾーショ	ぞうしょ、ゾウショ、蔵書
ゾーショク	ぞうしょく、ゾウショク、増殖
ゾーシン	ぞうしん、ゾウシン、増進
ゾースイ	ぞうすい、増水、造水
ゾーセイ	ぞうせい、ゾウセイ、造成
ゾーセツ	ぞうせつ、ゾウセツ、増設
ゾーセン	ぞうせん、ゾウセン、造船
ゾーゼイ	増税
ゾータン	ぞうたん、増反
ゾーダイ	ぞうだい、ゾウダイ、増大
ゾーチ	ぞうち、増置
ゾーチク	増築
ゾーチョー	ぞうちょう、増ちょう、増徴、増長
ゾーテイ	ぞうてい、ゾウテイ、贈呈
ゾートク	蔵匿
ゾートー	ぞうとう、贈答
ゾーハ	ぞうは、増派
ゾーハイ	ぞうはい、増配
ゾーハツ	増発
ゾーハン	増販、造反
ゾービン	増便
ゾーフク	ぞうふく、増巾、増幅
ゾーヘイ	増兵
ゾーページ	増ページ、増頁
ゾーホ	増補
ゾーホー	ぞうほう、増俸
ゾーヨ	ぞうよ、贈与
ゾーリュー	造立
ゾーリョク	ぞうりょく、増力
ゾーリョー	増量
ゾーリン	ぞうりん、造林
ゾーワイ	贈賄
タイ	対、帯
タイアタリ	たいあたり、体あたり、体当たり、体当り
タイアップ	タイアップ
タイイ	たいい、タイイ、退い、退位
タイイン	たいいん、タイイン、退院
タイエキ	たいえき、退役
タイオー	たいおう、タイオウ、対応
タイカ	たいか、タイカ、滞貨、退か、退化
タイカイ	たいかい、タイカイ、退会
タイカン	たいかん、タイカン、大かん、大観、退かん、退官
タイガク	退学
タイガン	たいがん、たい顔、タイガン、対がん、対顔
タイキ	たいき、タイキ、待機
タイキャク	退却
タイキョ	大挙、退去
タイキョク	たいきょく、タイキョク、対局
タイキョー	たいきょう、タイキョウ、滞京、退京
タイキン	退勤
タイギョー	怠業
タイクツ	たいくつ、退屈
タイクー	たいくう、滞空
タイグー	たいぐう、待遇
タイケツ	たいけつ、タイケツ、対決
タイケン	たいけん、タイケン、体けん、体験、帯剣
タイゲン	たいげん、タイゲン、体現、大げん、大言
タイゲンソーゴ	大言壮語
タイコ	大呼
タイコー	たいこう、対抗、対校、退こう、退校、退行
タイゴ	たいご、タイゴ、大悟、対晤、対語
タイゴテッテイ	大悟徹底
タイサク	たいさく、タイサク、対策
タイサン	たいさん、タイサン、退散
タイザ	たいざ、タイザ、対坐、対座、退座
タイザイ	たいざい、タイザイ、滞在
タイシツ	たいしつ、タイシツ、対質、退室
タイシャ	たいしゃ、タイシャ、代謝、退社
タイシャク	たいしゃく、タイシャク、貸借
タイシュツ	帯出、退出
タイショ	たいしょ、タイショ、大書、対処
タイショク	たいしょく、たい色、タイショク、大食、褪色、退職、退色
タイショー	たいしょう、タイショウ、大勝、大捷、対照
タイシン	たいしん、タイシン、対審
タイジ	たいじ、対じ、対峙、対峠、帯磁、退治
タイジョー	たいじょう、タイジョウ、退城、退場
タイジン	たいじん、タイジン、対陣、滞陣、退陣
タイスイ	たいすい、大酔
タイセイ	たいせい、大せい、大成、対生
タイセキ	たいせき、たい積、堆積、滞積、退席
タイセン	たいせん、タイセン、対戦
タイソク	たいそく、大息
タイソー	体操
タイゾー	たいぞう、タイゾウ、退蔵
タイダン	たいだん、タイダン、対談、退団
タイチ	たいち、タイチ、対置
タイチョー	たいちょう、タイチョウ、退庁
タイテイ	退廷
タイテン	たいてん、退転
タイデン	たいでん、帯電
タイトク	たいとく、体得
タイトー	たいとう、たい頭、タイトウ、台頭、対当、帯刀、擡頭
タイドー	たいどう、タイドウ、帯同、胎動
タイニチ	たい日、滞日
タイニン	たいにん、タイニン、体認、退任
タイノー	たいのう、タイノウ、怠納、滞納
タイハ	たいは、タイハ、大は、大破
タイハイ	たいはい、たい廃、タイハイ、大はい、大敗、退廃、頽廃
タイヒ	たいひ、対比、待避、退避
タイビョー	大病
タイプ	タイプ
タイベツ	大別
タイホ	たいほ、タイホ、退歩、逮捕
タイボー	たいぼう、待望、耐乏
タイメイ	たいめい、待命
タイメン	たいめん、タイメン、対面
タイヨ	たいよ、タイヨ、貸与
タイリツ	たいりつ、対立
タイリュー	たいりゅう、滞留
タイロン	たいろん、タイロン、対論
タイワ	たいわ、たい話、タイワ、対話
タカアゲ	高上げ
タカイ	他界
タカトビ	たかとび、タカトビ、高とび、高飛び
タカノゾミ	高望み
タカラサガシ	たからさがし、宝さがし、宝探し
タカワライ	高笑い
タキダシ	炊き出し、炊出し
タキビ	たき火、焚き火、焚火
タキョクカ	多極化
タギョー	他行
タク	托、託
タクイツ	たくいつ、択一
タクエツ	卓越
タクシュツ	卓出
タクショク	たくしょく、タクショク、拓植、拓殖
タクゼツ	卓絶
タクソー	たくそう、託送
タクハイ	たくはい、タクハイ、宅配
タクハツ	たくはつ、たく鉢、托鉢
タクバツ	卓抜
タクマ	たくま、たく磨、タクマ、琢磨
タクリツ	卓立
タゲン	たげん、多言
タゴン	たごん、タゴン、他言
タサク	たさく、多作
タシザン	たしざん、たし算、足し算、足算
タシャ	たしゃ、タシャ、多謝
タシュツ	他出
タショク	多食
タジタジ	たじたじ、タジタジ
タセン	たせん、他薦
タチウリ	立売
タチオージョー	立ち往生、立往生
タチギキ	立ち聞き
タチション	立ちション、立ション
タチバナシ	たちばなし、たち話、立ち話、立話
タチミ	たちみ、たち見、立ち見、立み、立見
タッカン	たっかん、タッカン、達観
タッキュー	たっきゅう、タッキュウ、卓球
タッキョ	たっきょ、謫居
タックル	タックル
タッセイ	たっせい、たっ成、タッセイ、達成
タッチ	タッチ
タテカエ	たてかえ、立てかえ、立て替、立て替え、立替、立替え
タテジカ	縦磁化
タテマシ	たてまし、建て増し、建増し
タドク	タドク、多読
タナアゲ	たなあげ、たな上げ、タナ上げ、棚上、棚上げ
タナオロシ	たなおろし、たな卸、店卸、店卸し、棚おろし、棚卸、棚卸し
タネアカシ	たねあかし、タネ明かし、種明かし、種明し
タハツ	たはつ、タハツ、多発
タビ	旅
タムロ	たむろ、屯
タヨー	たよう、タヨウ、多用
タンイツカ	単一化
タンカ	たんか、炭化
タンガン	たんがん、タンガン、嘆願、歎願
タンキュー	たんきゅう、タンキュウ、探求、探究
タンケン	たんけん、タンケン、探検、探険
タンゲイ	たんげい、端げい、端倪
タンコー	たんこう、タンコウ、単行
タンサ	たんさ、タンサ、探査
タンサク	たんさく、タンサク、単作、探索
タンサツ	探察
タンザ	たんざ、タンザ、端坐、端座
タンシュク	たんしゅく、タンシュク、短縮
タンショー	たんしょう、嘆称、嘆賞、探勝、歎称
タンジョー	たんじょう、誕じょう、誕生
タンセイ	丹精、丹誠
タンソク	たんそく、タンソク、嘆息、探測、歎息
タンゾー	たんぞう、鍛造
タンチ	たんち、タンチ、探知
タンテイ	たんてい、タンテイ、探偵
タンデキ	たんでき、耽溺
タントー	たんとう、タントウ、担当
タンドク	たんどく、たん読、タンドク、耽読
タンニン	たんにん、担任
タンノー	たんのう、たん能、堪能
タンバイ	たんばい、タンバイ、探梅
タンビ	嘆美、歎美
タンブン	たんぶん、タンブン、探聞
タンボー	たんぼう、たん訪、探ぼう、探訪
タンポ	たんぽ、タンポ、担保
タンム	たんむ、坦務
タンヤ	たんや、タンヤ、鍛冶
タンラク	たんらく、短絡
タンレン	たんれん、鍛練、鍛錬
ターン	ターン
ターンオフ	ターンオフ
ダイイ	だいい、ダイイ、代い、代位
ダイエット	ダイエット
ダイオージョー	だいおうじょう、大おうじょう、大往じょう
ダイカツ	だいかつ、ダイカツ、大かつ、大喝
ダイガン	だいがん、ダイガン、代願
ダイキュー	だいきゅう、ダイキュウ、代休
ダイギ	だいぎ、代議
ダイケツ	代決
ダイゲン	だいげん、ダイゲン、代言
ダイコー	だいこう、ダイコウ、代行、代講、代香
ダイサク	だいさく、ダイサク、代作
ダイサン	だいさん、ダイサン、代さん、代参
ダイショ	だいしょ、代書、代署
ダイショー	だいしょう、ダイショウ、代償
ダイシン	だいしん、ダイシン、代診
ダイジェスト	ダイジェスト
ダイタイ	代替
ダイチ	だいち、ダイチ、代置
ダイドク	代読
ダイドー	だいどう、ダイドウ、大どう、大同
ダイドーダンケツ	大同団結
ダイニュー	代入
ダイニン	だいにん、ダイニン、代任
ダイノー	だいのう、代納
ダイハッケン	だいはっけん、大はっけん、大発見
ダイバライ	代払、代払い
ダイヒツ	代筆
ダイヒョー	だいひょう、ダイヒョウ、代表
ダイビング	ダイビング
ダイベン	だいべん、代弁
ダイヤル	ダイヤル
ダイヨー	だいよう、代用
ダイリ	だいり、代理
ダウン	ダウン
ダウンロード	ダウンロード
ダカイ	だかい、打開
ダカン	だかん、だ換、ダカン、兌換
ダキ	だき、だ棄、ダキ、唾棄
ダキョー	だきょう、妥協
ダク	諾
ダケツ	だけつ、妥結
ダケン	だけん、打鍵
ダコー	だこう、だ行、蛇行
ダサン	ださん、打さん、打算
ダシイレ	だしいれ、出し入れ
ダシン	だしん、打診
ダタイ	だたい、ダタイ、堕胎
ダッ	脱
ダッカ	だっか、ダッカ、脱化
ダッカイ	だっかい、奪回、脱会
ダッカン	だっかん、奪還
ダッキャク	だっきゃく、脱却
ダッキュー	だっきゅう、脱きゅう、脱臼
ダッキョ	脱去
ダッキング	ダッキング
ダッコ	だっこ、ダッコ、抱っこ
ダッコク	だっこく、脱穀
ダッコー	だっこう、だっ稿、脱こう、脱肛
ダッサン	だっさん
ダッシ	だっし、ダッシ、脱し、脱脂
ダッシュ	だっしゅ、だっ取、ダッシュ、奪取
ダッシュツ	だっしゅつ、だっ出、ダッシュツ、脱出
ダッシュー	だっしゅう、脱臭
ダッショク	だっしょく、だっ色、脱色
ダッスイ	だっすい、だっ水、脱水
ダッセン	だっせん、だっ線、ダッセン、脱線、脱船
ダッソー	だっそう、だっ走、脱そう、脱走
ダッタイ	だったい、脱退
ダッチャク	脱着
ダッチョー	だっちょう、脱腸
ダットー	だっとう、だっ党、脱党
ダッパン	だっぱん、脱藩
ダッピ	だっぴ、ダッピ、脱皮
ダップン	だっぷん、脱糞
ダツイ	だつい、脱衣
ダツエイ	脱営
ダツゴク	脱獄
ダツゼイ	脱税
ダツゾク	脱俗
ダツボー	脱帽
ダツモー	脱毛
ダツラク	脱落
ダツリャク	奪掠、奪略
ダツロー	だつろう、脱ろう、脱漏、脱牢
ダデン	だでん、打電
ダトー	だとう、ダトウ、妥当、打とう、打倒
ダハ	だは、打は、打破
ダビング	ダビング
ダホ	だほ、だ捕、拿捕
ダボク	だぼく、打撲
ダラク	だらく、ダラク、堕落
ダンアツ	弾圧
ダンガイ	だんがい、弾劾
ダンギ	だんぎ、談義、談議
ダンケツ	だんけつ、団結
ダンゲン	だんげん、断言
ダンコー	だんこう、断交、断行
ダンゴー	だんごう、談合
ダンサイ	断截、断裁
ダンザイ	断罪
ダンシュ	断種
ダンショー	だんしょう、談笑
ダンジキ	だんじき、ダンジキ、断食
ダンス	ダンス
ダンスイ	断水
ダンセン	だんせん、断線
ダンゼツ	断絶
ダンソー	だんそう、ダンソウ、弾奏、男そう、男装
ダンゾク	断続
ダンテイ	だんてい、断定
ダンドリ	だんどり、ダンドリ、段どり、段取、段取り
ダンネン	だんねん、断念
ダンパツ	だんぱつ、断ぱつ、断髪
ダンパン	だん判、談ぱん、談判
ダンピング	ダンピング
ダンプ	ダンプ
ダンボー	暖房、煖房
ダンメツ	断滅
ダンラン	だんらん、ダンラン、団らん、団欒
ダンロン	談論
ダンワ	だんわ、談話
チ	治
チェック	チェック
チェックイン	チェックイン
チェンジ	チェンジ
チエン	ちえん、チエン、遅延
チカク	知覚
チカミチ	ちかみち、近道
チカラゾエ	力添え
チカラマケ	力負け
チカン	ちかん、ち換、チカン、置かん、置換
チギ	遅疑
チク	ちく、ち駆、馳駆
チクサン	ちくさん、チクサン、畜産
チクザイ	蓄財
チクジョー	ちくじょう、築城
チクセキ	ちくせき、チクセキ、蓄積
チクゾー	築造、蓄蔵
チクテイ	ちくてい、築堤
チクデン	ちくでん、蓄電、逐電
チクネツ	蓄熱
チクハツ	蓄髪
チクレイ	蓄冷
チコク	ちこく、チコク、遅刻
チサン	ちさん、ち参、チサン、遅参
チシ	致事、致仕
チシツ	ちしつ、知しつ、知悉
チスイ	ちすい、ち水、チスイ、治水
チソー	ちそう、チソウ、馳走
チタイ	ちたい、チタイ、遅滞
チダツ	褫奪
チッキョ	ちっきょ、ちっ居、蟄居
チッコー	ちっこう、ちっ港、チッコウ、築こう、築港
チッシ	ちっし、窒死
チッソク	ちっそく、ちっ息、チッソク、窒息
チップ	チップ
チトク	ちとく、チトク、知得
チハイ	遅配
チハツ	ちはつ、ち髪、薙髪
チマチマ	ちまちま
チャク	着
チャクイ	ちゃくい、着い、着意、着衣
チャクガン	着岸、着眼
チャクザ	着座
チャクシュ	着手
チャクシュツ	嫡出
チャクショク	ちゃくしょく、着色
チャクシン	ちゃくしん、着信
チャクジン	着陣
チャクスイ	着水
チャクセイ	ちゃくせい、着生
チャクセキ	着席
チャクセン	着船
チャクソー	ちゃくそう、着そう、着想
チャクタイ	着たい、着タイ、着帯
チャクダツ	着脱
チャクダン	着弾
チャクチ	ちゃくち、着地
チャクデン	着電
チャクニン	着任
チャクヒツ	着筆
チャクフク	着服
チャクモク	着目
チャクヨー	ちゃくよう、チャクヨウ、着用
チャクリク	ちゃくりく、着陸
チャッカ	ちゃっか、チャッカ、着か、着カ、着火、着荷
チャッキン	着金
チャッケン	ちゃっけん、着けん、着剣
チャッコー	ちゃっこう、着こう、着工
チャラチャラ	チャラチャラ
チャレンジ	チャレンジ
チャージ	チャージ
チャーター	チャーター
チャーム	チャーム
チュー	沖
チューイ	ちゅうい、チュウイ、注い、注意
チューカイ	ちゅうかい、チュウカイ、仲介、注解、註解
チューカン	ちゅうかん、チュウカン、忠諌
チューガエリ	ちゅうがえり、宙がえり、宙返り
チューキ	ちゅうき、ちゅう記、チュウキ、注き、注記、註記
チューキュウ	ちゅうきゅう
チューキュー	誅求
チューキン	ちゅうきん、忠勤
チューギ	ちゅうぎ、忠義
チューケイ	ちゅうけい、チュウケイ、中継
チューコク	ちゅうこく、忠告
チューコー	ちゅうこう、チュウコウ、中こう、中耕
チューサイ	ちゅうさい、仲裁
チューサツ	ちゅうさつ、ちゅう殺、誅殺、駐さつ、駐箚
チューザ	中座
チューザイ	ちゅうざい、駐在
チューシ	ちゅうし、チュウシ、中し、中止、注し、注視
チューシャ	ちゅう射、注射、駐車
チューシャク	チュウシャク、注釈、註釈
チューシュツ	ちゅうしゅつ、チュウシュツ、抽出
チューショー	ちゅうしょう、チュウショウ、中傷、抽象
チューシン	ちゅうしん、チュウシン、注進
チュージツカ	中実化
チュースイ	ちゅうすい、注水
チューセン	ちゅうせん、抽せん、抽籤、抽選
チューゼツ	中絶
チューゾー	ちゅうぞう、チュウゾウ、鋳造
チュータイ	ちゅうたい、中退
チューダン	ちゅうだん、チュウダン、中だん、中断
チューチョ	ちゅうちょ、躊躇
チュートン	ちゅうとん、駐とん、駐屯
チュードク	ちゅうどく、中毒
チューニチ	ちゅうにち、チュウニチ、駐日
チューニュー	注入
チューバツ	ちゅうばつ、誅伐
チューヘイ	ちゅうへい、駐兵
チューメツ	誅滅
チューモク	ちゅうもく、チュウモク、注目
チューモン	ちゅうもん、チュウモン、注文、註文
チューユ	注油
チューリク	ちゅうりく、誅戮
チューリツ	ちゅうりつ、中立
チューリャク	中略
チューリュー	ちゅうりゅう、駐留
チューリョク	注力
チューワ	ちゅうわ、中わ、中和
チユ	治ゆ、治癒
チョキン	ちょきん、ちょ金、チョキン、貯金
チョクエイ	直営
チョクオーマイシン	直往邁進
チョクゲキ	ちょくげき、直撃
チョクゲン	直言
チョクサイ	ちょくさい、直裁
チョクシ	ちょくし、直視
チョクシャ	直射
チョクシン	直進
チョクジョ	直叙
チョクジョー	直上
チョクセン	ちょくせん、勅せん、勅撰
チョクソー	直送
チョクゾク	直属
チョクツー	直通
チョクトー	ちょくとう、勅答、直答
チョクドク	直読
チョクバイ	ちょくばい、直売
チョクヒツ	直筆
チョクメン	直面
チョクヤク	直訳
チョクユシュツ	直輸出
チョクユニュー	直輸入
チョクリツ	直立
チョクリュー	直流
チョサク	ちょさく、チョサク、著作
チョジュツ	著述
チョスイ	ちょすい、貯水
チョゾー	ちょぞう、貯蔵
チョチク	ちょちく、チョチク、貯蓄
チョッカ	ちょっか、チョッカ、直か、直下
チョッカク	ちょっかく、ちょっ覚、直覚
チョッカツ	ちょっかつ、ちょっ轄、直轄
チョッカン	ちょっかん、チョッカン、直感、直観、直諌
チョッケツ	ちょっけつ、直結
チョッコー	ちょっこう、ちょっ航、ちょっ行、直こう、直交、直航、直行
チョトツ	ちょとつ、ちょ突、猪突
チョリツ	ちょりつ、ちょ立、佇立
チョリュー	潴溜、貯留
チョロク	ちょろく、著録
チョー	寵、弔、徴
チョーアイ	ちょうあい、ちょう愛、寵愛
チョーイ	ちょうい、チョウイ、弔慰
チョーイン	ちょういん、調印
チョーエツ	ちょうえつ、超越
チョーカ	ちょうか、チョウカ、超か、超過
チョーカイ	ちょうかい、チョウカイ、懲戒、潮解
チョーカン	ちょうかん、鳥かん、鳥瞰
チョーガ	ちょうが、チョウガ、朝が、朝賀
チョーキョ	聴許
チョーキョー	ちょうきょう、調教
チョーキン	ちょうきん、彫金、超勤
チョーク	ちょうく、チョーク、長駆
チョーケシ	帳消し
チョーケツ	長欠
チョーコク	ちょうこく、チョウコク、彫刻、超克
チョーコー	ちょうこう、チョウコウ、朝こう、朝貢、聴こう、聴講、長こう、長考
チョーゴー	ちょうごう、調合
チョーサ	ちょうさ、調査
チョーザ	長座
チョーザイ	調剤
チョーシュ	聴取
チョーシュー	ちょうしゅう、チョウシュウ、徴収、徴集
チョーショク	ちょうしょく、チョウショク、朝食
チョーショー	ちょうしょう、ちょう笑、嘲笑、長しょう、長嘯
チョーシン	ちょうしん、聴診、調進
チョージュー	ちょうじゅう、聴従
チョージョー	ちょうじょう、重畳
チョーセイ	ちょうせい、チョウセイ、調整、調製、長生、長逝
チョーセツ	ちょうせつ、調節
チョーセン	ちょう戦、挑戦
チョーゼイ	徴税
チョーゼツ	超絶
チョータイソク	長大息
チョータク	ちょうたく、彫たく、彫琢
チョータツ	ちょうたつ、チョウタツ、調達
チョータン	ちょうたん、長嘆、長歎
チョーダイ	ちょうだい、頂だい、頂戴
チョーダツ	超脱
チョーチャク	ちょうちゃく、打擲
チョーテイ	ちょうてい、チョウテイ、調停
チョーノー	ちょうのう、聴納
チョーハツ	ちょうはつ、徴発、挑撥、挑発、調髪
チョーバ	ちょうば、嘲罵
チョーバツ	懲罰
チョーフ	ちょうふ、ちょう付、チョウフ、貼付、貼附
チョーフク	ちょうふく、チョウフク、重複
チョーブク	ちょうぶく、調ぶく、調伏
チョーヘイ	ちょうへい、徴兵
チョーホー	重宝
チョーボ	ちょうぼ、チョウボ、徴募
チョーボー	ちょうぼう、眺望
チョーミ	ちょうみ、調味
チョーモン	ちょうもん、弔問、聴聞
チョーヤク	ちょうやく、調薬、跳躍
チョーヨー	徴用、貼用、重用
チョーラク	ちょうらく、ちょう落、凋落
チョーリ	ちょうり、調理
チョーリツ	ちょうりつ、チョウリツ、調律
チョーリョー	ちょうりょう、跳りょう、跳梁
チョーレイ	ちょうれい、チョウレイ、朝礼
チョーレン	ちょうれん、調練
チョーロー	ちょうろう、嘲弄
チョーワ	ちょうわ、調和
チリョー	ちりょう、チリョウ、治りょう、治療
チン	チン
チンアゲ	賃上げ
チンアツ	鎮圧
チンカ	ちんか、沈下、鎮火
チンコー	ちんこう、沈降
チンゴ	ちんご、鎮護
チンサゲ	賃下げ
チンザ	ちんざ、鎮座
チンシ	ちんし、沈思
チンシャ	陳謝
チンシャク	賃借
チンジュツ	陳述
チンジョー	ちんじょう、陳情
チンスイ	ちんすい、沈酔
チンセイ	ちんせい、沈静、鎮静
チンセキ	沈積
チンセン	ちんせん、沈潜
チンゾー	ちんぞう、珍蔵
チンタイ	ちんたい、沈滞、賃貸
チンチャク	ちんちゃく、沈着
チンチョー	ちんちょう、珍重
チンテイ	鎮定
チンデン	ちんでん、沈でん、沈殿、沈澱
チンニュー	ちんにゅう、ちん入、闖入
チンブ	ちんぶ、鎮ぶ、鎮撫
チンベン	陳弁
チンボツ	ちんぼつ、沈没
チンメン	ちんめん、沈めん、沈湎
チンモク	ちんもく、沈黙
チンリン	ちんりん、沈りん、沈淪
チンレツ	ちんれつ、陳列
ツイオク	ついおく、追憶
ツイカ	ついか、追加
ツイカイ	ついかい、追懐
ツイキ	ついき、追記
ツイキュー	ついきゅう、追及、追求、追究、追窮、追給
ツイゲキ	追撃
ツイコー	ついこう、追孝、追考
ツイシ	ついし、墜死、追試
ツイショー	ついしょう、追従
ツイジュー	ついじゅう、追従
ツイズイ	追随
ツイセキ	ついせき、追跡
ツイゼン	ついぜん、追善
ツイソ	ついそ、追訴
ツイソー	ついそう、追想
ツイゾー	追贈
ツイチョー	追弔、追徴
ツイトツ	追突
ツイトー	ついとう、追悼、追討
ツイニン	追認
ツイビ	追尾
ツイホー	ついほう、追放
ツイボ	ついぼ、追慕
ツイラク	ついらく、墜落
ツイロク	追録
ツキバライ	月払、月払い
ツミカエ	積み換え、積み替え、積換え、積替え
ツミホロボシ	罪ほろぼし、罪滅ぼし
ツメナオシ	つめ直し、詰めなおし、詰め直し、詰直し
ツヤ	通夜
ツユイリ	つゆいり、梅雨入り
ツーイン	つういん、痛飲、通院
ツーエン	つうえん、通園
ツーカ	つうか、通過
ツーカン	つうかん、痛感、通観、通関
ツーガク	つうがく、通学
ツーキン	つうきん、通勤
ツーギョー	通暁
ツーケイ	通計
ツーゲキ	痛撃
ツーゲン	痛言
ツーコク	つうこく、つう告、痛こく、痛哭、通告
ツーコン	つうこん、痛恨
ツーコー	つうこう、通交、通航、通行
ツーサン	つうさん、通算
ツーショー	つうしょう、通商
ツーシン	痛心、通信
ツーセキ	痛惜
ツータツ	通達
ツータン	痛嘆、痛歎
ツーチ	つうち、通知
ツーチョー	つうちょう、通ちょう、通牒
ツーデン	通電
ツードク	通読
ツーバ	つうば、痛ば、痛罵
ツーフン	痛憤
ツーブン	通分
ツーホー	つうほう、通報
ツーボー	通謀
ツーヤク	つうやく、通約、通訳
ツーヨー	つうよう、通用
ツーラン	通覧
ツーリング	ツーリング
ツーロン	痛論
ツーワ	つうわ、通話
テアテ	てあて、テアテ、手あて、手当、手当て
テアワセ	手合せ、手合わせ
ティーアップ	ティーアップ
テイ	呈、挺、訂
テイアン	ていあん、提案
テイイ	ていい、定位
テイカ	ていか、低下
テイカイ	ていかい、低回、低徊、停会
テイカン	ていかん、てい観、諦観
テイキ	ていき、提起
テイキュー	ていきゅう、てい泣、涕泣
テイキョー	ていきょう、提供
テイギ	ていぎ、定義、提議
テイギン	低吟
テイケイ	ていけい、テイケイ、提携
テイケツ	ていけつ、締結
テイゲン	ていげん、低減、提言、逓減
テイコー	ていこう、抵抗
テイサツ	ていさつ、偵察
テイザ	ていざ、鼎坐
テイシ	ていし、てい視、テイシ、停止、底し、底止
テイシャ	ていしゃ、停車
テイシュツ	ていしゅつ、呈出、提出
テイショク	ていしょく、てい触、定植、抵触、牴触、觝触
テイショー	ていしょう、低唱、提唱
テイシン	ていしん、てい身、てい進、挺身、挺進
テイジ	ていじ、テイジ、呈示、提示
テイジュー	ていじゅう、定住
テイジョー	ていじょう、呈上
テイセイ	ていせい、訂正
テイセン	ていせん、停戦、停船
テイソ	ていそ、提訴
テイソー	ていそう、逓送
テイゾー	ていぞう、逓増
テイタイ	停滞
テイダン	ていだん、てい談、鼎談
テイチ	ていち、定置
テイチャク	ていちゃく、定着
テイデン	ていでん、停電、逓伝
テイトン	ていとん、停とん、停頓
テイトー	ていとう、低頭
テイハク	ていはく、てい泊、停泊、碇泊
テイハツ	ていはつ、てい髪、剃髪
テイメイ	ていめい、低迷
テイヤク	締約
テイラク	ていらく、低落
テイリツ	ていりつ、てい立、定立、鼎立
テイリュー	ていりゅう、停留
テイレ	ていれ、手いれ、手入れ
テカゲン	てかげん、手かげん、手加減
テガキ	てがき、手がき、手書き
テキ	適
テキオー	てきおう、適応
テキカ	てきか、摘果、滴下
テキガ	てきが、摘芽
テキゴー	てきごう、適合
テキシ	てきし、敵視
テキシュツ	てきしゅつ、剔出、摘出
テキシン	てきしん、摘心
テキジュー	適従
テキジョ	てきじょ、てき除、摘除
テキタイ	てきたい、敵対
テキチュー	てきちゅう、的中、適中
テキハツ	摘発
テキヨー	てきよう、摘要、適用
テキロク	摘録
テコイレ	てこ入れ、テコ入れ、梃入れ
テジナ	てじな、テジナ、手品
テスト	テスト
テズマリ	手づまり、手詰まり、手詰り
テダスケ	てだすけ、手だすけ、手助け
テダテ	てだて、手だて、手立て
テッ	徹
テッカイ	てっかい、てっ回、撤回
テッキ	てっき、てっ帰、てっ記、テッキ、摘記、適帰
テッキョ	てっきょ、てっ去、テッキョ、撤去
テッケツ	てっけつ、剔抉
テッシュー	てっしゅう、てっ収、撤収
テッタイ	てったい、てっ底、てっ退、テッテイ、撤退
テッテイ	てってい、徹底
テッパイ	てっぱい、て廃、撤廃
テッペイ	てっぺい、て兵、テッペイ、撤兵
テツズキ	てつづき、テツヅキ、手つづき、手続、手続き
テツヤ	てつや、徹夜
テナオシ	てなおし、手なおし、手直し
テヌキ	てぬき、テヌキ、手抜、手抜き
テハイ	てはい、テハイ、手配
テヒラキ	手開き
テマネキ	てまねき、手まねき、手招、手招き
テマワシ	てまわし、手まわし、手回し
テル	ＴＥＬ
テレワライ	照れ笑い
テワケ	てわけ、手分、手分け
テワタシ	てわたし、手わたし、手渡、手渡し
テンイ	てんい、テンイ、転い、転位、転移
テンエン	てんえん、展延
テンカ	てんか、てん加、添加、点火、転か、転化、転嫁、転訛
テンカイ	てんかい、展開、転回
テンカン	展観、転換
テンガク	てんがく、転学
テンガン	てんがん、点眼
テンキ	転記
テンキョ	転居
テンキン	てんきん、転勤
テンギョー	てんぎょう、転業
テンケン	てんけん、点検
テンコ	てんこ、点呼
テンコク	てんこく、てん刻、篆刻
テンコー	てんこう、転向、転校
テンサイ	転載
テンサク	てんさく、添削
テンザイ	点在
テンシ	展し、展翅
テンシャ	てんしゃ、転写
テンシャク	転借
テンシュク	転宿
テンシュツ	転出
テンショ	てんしょ、てん書、添書
テンショク	てんしょく、転職
テンシン	てんしん、転身、転進
テンジ	てんじ、展示
テンジュー	転住
テンジョー	てんじょう、テンジョウ、添乗、纏繞、転乗
テンセイ	てんせい、転成、転生
テンセキ	てんせき、転籍
テンセン	てんせん、転戦
テンソー	てんそう、伝奏、転送
テンゾク	転属
テンタイ	てんたい、転貸
テンタイシャク	転貸借
テンタク	転宅
テンチ	てんち、転地、転置
テンチョー	てんちょう、転調
テンテイ	てんてい、点綴
テンテキ	てんてき、点滴
テンテコマイ	てんてこまい、てんてこ舞い、テンテコマイ、天手古舞
テンテツ	てんてつ、点綴
テンテン	てんてん、てん転、転々、転てん、転転、輾転
テンテンハンソク	輾転反側
テント	てん都、奠都
テントー	てんとう、点とう、点灯、点頭、転とう、転倒、顛倒
テンドク	転読
テンニュー	転入
テンニン	てんにん、転任
テンバイ	てんばい、転売
テンビキ	天引、天引き
テンビョー	点描
テンプ	てんぷ、添ぷ、添付、添附、貼付、貼附
テンプク	てんぷく、転ぷく、転覆、顛覆
テンペン	てんぺん、転ぺん、転変
テンボ	てんぼ、展墓
テンボー	てんぼう、テンボウ、展望
テンポ	てんぽ、てん補、填ぽ、填補、転ぽ、転補
テンメツ	てんめつ、点滅
テンメン	てんめん、てん綿、テンメン、纏綿
テンヤク	てんやく、点訳
テンヨー	てんよう、転用
テンラク	てんらく、転落、顛落
テンラン	てんらん、展覧
テークオフ	テークオフ
ディスカウント	ディスカウント
ディスカッション	ディスカッション
ディベート	ディベート
デイスイ	でいすい、でい酔、泥酔
デイリ	でいり、デイリ、出入、出入り
デカセギ	出稼、出稼ぎ
デキアイ	できあい、でき愛、溺愛
デキシ	できし、でき死、デキシ、溺死
デキボツ	できぼつ、でき没、溺没
デコボコ	でこぼこ、デコボコ、凸凹
デコード	デコード
デザイン	デザイン
デジケート	デジケート
デバック	デバック
デバッグ	デバッグ
デビュー	デビュウ、デビュー
デフォルメ	デフォルメ
デムカエ	でむかえ、出迎、出迎え
デモ	デモ
デモンストレーション	デモンストレーション
デレデレ	でれでれ、デレデレ
デンカ	でんか、電化、電荷
デンカイ	でんかい、電解
デンゴン	でんごん、伝言
デンシャ	でんしゃ、伝写
デンシュー	伝習
デンショー	でんしょう、伝承
デンジュ	でんじゅ、伝授
デンセイ	でんせい、電請
デンセン	伝染
デンソー	でんそう、伝送、電送
デンタツ	でんたつ、伝達
デント	電鍍
デンドー	でんどう、伝動、伝導、伝道
デンパ	でんぱ、伝ぱ、伝播
デンパン	伝搬、伝播
デンブン	でんぶん、伝聞
デンボー	でんぼう、伝法
デンライ	でんらい、伝来
デンリ	電離
デンワ	でんわ、電話
デート	デート
ト	賭
トイアワセ	といあわせ、問い合せ、問い合わせ、問合せ、問合わせ
トイキ	といき、吐息
トウカイ	とうかい、韜晦
トウゴウ	とうごう
トカ	渡河
トカイ	とかい、渡海
トキン	ときん、鍍金
トギョ	とぎょ、渡御
トク	督
トクシャ	特赦
トクシュツ	特出
トクシュー	とくしゅう、特輯、特集
トクショク	とくしょく、とく職、トクショク、涜職
トクショー	とくしょう、読誦
トクシン	とくしん、得心、特進
トクセツ	特設
トクセン	とくせん、とく戦、特せん、特薦、特選、督戦
トクソ	特措
トクソク	とくそく、督促
トクタイ	特待
トクチュー	特注
トクテイ	とくてい、特定
トクテン	とくてん、得点
トクド	とくど、得度
トクドー	とくどう、得道
トクニン	特認
トクハ	とくは、特派
トクハイ	特配
トクハツ	特発
トクバイ	特売
トクヒツ	特筆
トクヒツタイショ	特筆大書
トクヒョー	得票
トクホー	とくほう、特報
トクメン	特免
トクヤク	とくやく、特約
トクレイ	とくれい、督励
トケツ	とけつ、吐血
トコー	渡航
トサツ	とさつ、と擦、と殺、トサツ、塗擦、屠殺
トザン	とざん、登ざん、登山
トシ	と死、徒し、徒死
トシャ	としゃ、吐しゃ、吐瀉
トシュツ	吐出
トショク	徒食
トショー	としょう、徒渉、渡渉
トジマリ	とじまり、と締、と締まり、と締り、戸締、戸締まり、戸締り
トジョー	とじょう、登城
トス	トス
トゼツ	とぜつ、と絶、杜絶、途絶
トソー	とそう、塗装
トチョー	とちょう、徒長
トッカ	とっか、とっ化、トッカ、徳か、徳化
トッカン	とっかん、とっ貫、トッカン、吶喊、突かん、突貫
トッキ	とっき、とっ記、とっ起、トッキ、特記、突き、突起
トッキョ	とっきょ、とっ許、トッキョ、特許
トックン	とっくん、特訓
トッケイ	とっけい、とっ掲、トッケイ
トッシュツ	とっしゅつ、とっ出、突出
トッシン	とっしん、とっ進、突進
トッパ	とっぱ、トッパ、突っぱ、突破
トッパツ	とっぱつ、突発
トッピング	とっぴんぐ、とっぴん具、トッピング
トツゲキ	とつげき、突撃
トツニュー	とつにゅう、突入
トトー	ととう、渡島
トドケデ	とどけで、届け出、届出
トニュー	とにゅう、吐乳
トヒ	徒費
トビヒ	とびひ、飛び火
トフ	塗布
トフク	とふく、と腹、屠腹
トベイ	とべい、渡米
トマツ	とまつ、塗抹
トモバタラキ	とも働き、共働き
トヨー	とよう、渡洋
トライ	とらい、トライ、渡来
トラップ	トラップ
トラバース	トラバース
トラバーユ	トラバーユ
トリガ	トリガ
トリザタ	取りざた、取り沙汰、取沙汰
トリシマリ	とりしまり、取りしまり、取り締まり、取締、取締まり、取締り
トリヒキ	とりひき、トリヒキ、取り引、取り引き、取引
トリミング	トリミング
トレツ	とれつ、と列、堵列
トレース	トレース
トレード	トレード
トレードオフ	トレードオフ
トレーニング	トレーニング
トロ	とろ、と露、トロ、吐露
トンエイ	屯営
トンゴ	とんご、とん悟、トンゴ、頓悟
トンザ	とんざ、とん挫、頓挫
トンシ	とんし、とん死、トンシ、頓し、頓死
トンシュ	とんしゅ、とん首、頓首
トンジャク	とんじゃく、頓着
トンズラ	とんずら、トンズラ
トンセイ	遁世
トンセー	とんせい、とん世
トンソー	とんそう、とん走、遁走
トンチャク	とんちゃく、とん着、頓着
トンネル	トンネル
トンプク	とんぷく、トンプク、頓服
トーイツ	とういつ、統一
トーイン	とういん、登院
トーエイ	とうえい、投影
トーカ	とうか、投下、等化、糖化、透過
トーカイ	とうかい、倒壊、倒潰
トーカイヒョー	投開票
トーカク	とうかく、倒閣
トーカツ	とうかつ、トウカツ、統括、統轄
トーカン	とうかん、投かん、投函、統監
トーキ	とうき、トウキ、投棄、登き、登記、騰貴
トーキュー	とうきゅう、投球、討究
トーキョク	とうきょく、登極
トーギ	とうぎ、討議
トーギョ	とうぎょ、統御
トークツ	盗掘
トーケイ	とうけい、統計
トーケツ	とうけつ、凍結
トーコー	とうこう、投稿、投降、登校、登降
トーゴク	とうごく、投獄
トーゴー	とうごう、投合、統合
トーサ	とうさ、踏査
トーサイ	とう載、搭載、登載、統裁
トーサク	とうさく、倒錯、盗作
トーサン	倒産
トーシ	とうし、凍死、投資、透視
トーシャ	とうしゃ、投写、投射、謄写、透写
トーシュク	投宿
トーシュツ	投出
トーシュー	とうしゅう、踏襲、蹈襲
トーショ	とうしょ、投書、頭書
トーシン	とうしん、投身、東進、答申
トージ	とうじ、湯治
トージョー	とうじょう、凍上、搭乗、東上、登場
トージン	とうじん、とう尽、トウジン、蕩尽
トースイ	とうすい、統帥、陶酔
トーセイ	とうせい、東征、統制
トーセキ	とうせき、悼惜、投石、透析
トーセン	とうせん、当せん、当籤、当選、東遷、登仙
トーゼン	東漸
トーソツ	とうそつ、統率
トーソー	とうそう、逃走、闘争
トータ	とうた、淘汰
トータツ	とうたつ、到達
トータル	トータル
トーダン	登壇
トーチ	とうち、倒置、統治
トーチャク	とうちゃく、到着
トーチョク	当直
トーチョー	とうちょう、トウチョウ、登庁、登頂、盗聴
トーテキ	とうてき、投てき、投擲
トーテツ	とうてつ、透徹
トーデ	とおで、遠出
トーデン	とうでん、盗電、答電
トードー	とうどう、東道
トーニュー	とうにゅう、投入
トーハ	とうは、踏破
トーハイゴー	統廃合
トーハン	とうはん、トウハン、登はん、登攀
トーバク	とうばく、倒幕、討幕
トーバツ	盗伐、討伐
トーバン	とうばん、当番、登板
トーヒ	とうひ、逃避
トーヒコー	逃避行
トーヒョー	とうひょう、投票
トービョー	とうびょう、投びょう、投錨、闘びょう、闘病
トーフク	とうふく、倒伏
トーブン	等分
トーベン	とうべん、答弁
トーホンセイソー	東奔西走
トーボー	とうぼう、逃亡
トーミン	とうみん、冬眠
トーヤ	とうや、陶や、陶冶
トーヤク	とうやく、投薬
トーヨ	とうよ、投与
トーヨー	とうよう、当用、登庸、登用、盗用
トーライ	とうらい、到来
トーリツ	とうりつ、倒立
トーリュー	とうりゅう、とう留、逗留
トーリョー	とうりょう、投了
トールイ	とうるい、盗塁
トーレイ	とうれい、答礼
トーロク	とうろく、登録
トーロン	とうろん、討論
トーロー	とうろう、登楼
トーワク	当惑
トーンダウン	トーンダウン
ドガイ	どがい、度外
ドガイシ	度外視
ドキョー	どきょう、ど経、読経
ドギマギ	どぎまぎ
ドクエン	独演
ドクガイ	毒害
ドクガク	独学
ドクギン	独吟
ドクゴ	独語
ドクサイ	どくさい、独裁
ドクサツ	毒殺
ドクザ	独坐、独座
ドクシ	どくし、毒死
ドクシャク	独酌
ドクシュー	独修、独習
ドクショ	どくしょ、読書
ドクショー	どくしょう、独唱
ドクジュ	どくじゅ、読誦
ドクズ	読図
ドクセン	どくせん、独占
ドクソー	どくそう、独そう、独創、独奏、独走
ドクダン	どくだん、独断
ドクハ	どくは、読破
ドクハク	独白
ドクリツ	どくりつ、独立
ドクリョー	読了
ドゲザ	どげざ、土下座
ドゴー	どごう、怒号
ドソー	どそう、土葬
ドチャク	土着
ドチョー	どちょう、怒張
ドッカ	どっ過、読過
ドッカイ	どっかい、どっ解、読解
ドッキョ	どっきょ、どっ居、独居
ドッキョー	読経
ドッキング	ドッキング
ドッコー	独航、独行
ドッポ	どっぽ、ドッポ
ドド	呶々、呶呶
ドライブ	ドライブ
ドリップ	ドリップ
ドリフト	ドリフト
ドリブル	ドリブル
ドリョク	どりょく、努力
ドレスアップ	ドレスアップ
ドロップ	ドロップ
ドン	鈍
ドンカ	どんか、鈍化
ドンショク	どんしょく、どん食、貪食
ドンゼイ	どんぜい、呑噬
ドント	どんと、どん吐、呑吐
ドンマ	どんま、鈍磨、鈍麻
ドーイ	どうい、同意
ドーイン	どういん、動員
ドーカ	同化
ドーカツ	どうかつ、どう喝、恫喝
ドーカン	どうかん、同感
ドーキ	どうき、同期
ドーキョ	どうきょ、同居
ドーキン	どうきん、同きん、同衾
ドーケイ	どうけい、憧憬
ドーコウ	どうこう、ドウコウ
ドーコク	どうこく、慟哭
ドーコー	どう行、同行
ドーサ	どうさ、どう作、動さ、動作
ドーサツ	どうさつ、洞さつ、洞察
ドーザ	どうざ、動ざ、動座、同ざ、同座
ドーシ	どうし、同視
ドーシツ	どうしつ、同室
ドーシャ	どうしゃ、同車
ドーシュク	同宿
ドーシュツ	導出
ドージョー	どうじょう、同乗、同情
ドースイ	どうすい、導水
ドーセイ	どうせい、同せい、同棲
ドーセキ	どうせき、同席
ドーセン	どうせん、同船
ドーチャク	どうちゃく、どう着、同着、撞着
ドーチョー	どうちょう、同調
ドーツー	導通
ドーテイ	どうてい、同定
ドーテン	どうてん、動転
ドードー	同道
ドーニュー	どうにゅう、導入
ドーハ	どうは、道破
ドーハン	どうはん、同伴
ドーフー	どうふう、同封
ドーメイ	どうめい、同盟
ドーモク	どうもく、どう目、瞠目
ドーヨー	どうよう、動揺
ドーラク	どうらく、道楽
ドーリュー	どうりゅう、同流
ナイエツ	内謁、内閲
ナイオー	ないおう、内応
ナイカン	ないかん、内観
ナイガン	ないがん、内含
ナイキン	ないきん、内勤
ナイコー	ないこう、内向、内攻
ナイサイ	ないさい、内済
ナイザイ	内在
ナイシャク	内借
ナイシュッケツ	ないしゅっけつ、内しゅっ血、内出血
ナイショク	ないしょく、内職
ナイシン	ないしん、内申、内診
ナイジ	ないじ、内示
ナイジョ	ないじょ、内じょ、内助
ナイセイ	ないせい、内省
ナイセツ	内切、内接
ナイソー	ないそう、内奏
ナイゾー	ないぞう、内蔵
ナイタツ	内達
ナイダク	内諾
ナイダン	ないだん、内談
ナイツー	ないつう、内通
ナイテイ	ないてい、内偵、内定
ナイナイテイ	内々定
ナイフク	ないふく、内服
ナイブン	ないぶん、内分
ナイホー	ないほう、内包
ナイメイ	内命
ナイヤク	内約
ナイヨー	ないよう、内用
ナイラン	ないらん、内覧
ナオシ	なおし、直し
ナカガイ	なかがい、仲がい、仲買
ナカタガイ	なかたがい、仲たがい、仲違い
ナカダチ	なかだち、仲立、仲立ち、媒
ナカダルミ	中だるみ、中弛み
ナカツギ	なかつぎ、中次ぎ、中継ぎ、仲次ぎ
ナカナオリ	なかなおり、仲直り
ナカマイリ	なかまいり、なかま入り、仲間いり、仲間入り
ナカマワレ	仲間われ、仲間割れ
ナガイ	長居
ナガイキ	ながいき、長生き
ナガツズキ	永続き、長続き
ナガモチ	ながもち、長もち、長持、長持ち
ナキネイリ	泣き寝入り、泣寝入、泣寝入り
ナザシ	なざし、名指し
ナッセン	なっせん、なっ染、ナッセン、捺染
ナットク	なっとく、納得
ナツイン	なついん、なつ印、捺印
ナナメギリ	ななめ切り、斜め切り
ナマロク	生録
ナンカ	なんか、南下、軟化
ナンキツ	難詰
ナンキン	なんきん、軟禁
ナンギ	なんぎ、難儀
ナンコー	なんこう、難航
ナンゴ	なんご、なん語、喃語
ナンザン	なんざん、難ざん、難産
ナンシン	なんしん、南進
ナンジュー	なんじゅう、難渋
ナンセン	なんせん、難船
ナンセンホクバ	南船北馬
ナンチャクリク	軟着陸
ナンチュー	なんちゅう、南中
ナンパ	なんぱ、ナンパ、軟派、難ぱ、難破
ナンメン	なんめん、南面
ニアゲ	にあげ、荷あげ、荷揚、荷揚げ
ニウケ	にうけ、荷うけ、荷受、荷受け
ニガワライ	にがわらい、にが笑い、ニガ笑い、苦笑い
ニクショク	にくしょく、肉食
ニクジキ	にくじき
ニクジキサイタイ	肉食妻帯
ニクハク	肉薄
ニシャサンニュー	二捨三入
ニジューカ	二重化
ニジョー	にじょう、二乗
ニズクリ	にづくり、荷づくり、荷造、荷造り
ニッキン	日勤
ニッコーヨク	日光浴
ニッサン	にっさん、にっ参、日参
ニッシンゲッポ	日進月歩
ニッソウ	にっそう
ニットー	にっとう、にっ唐、入唐
ニブン	にぶん、二分
ニモノ	にもの、煮もの、煮物
ニュウスイ	にゅうすい
ニュウロー	にゅう牢、入ろう
ニューイン	にゅういん、入院
ニューエイ	入営
ニューエン	にゅうえん、入園
ニューカ	にゅうか、乳化、入荷
ニューカイ	にゅうかい、入会
ニューカク	入閣
ニューカン	にゅうかん、入棺、入館
ニューガク	にゅうがく、入学
ニューキョ	にゅうきょ、入きょ、入居、入渠
ニューキョク	入局
ニューキョー	入京、入鋏
ニューキン	入金
ニューギョ	入漁
ニューコ	入庫
ニューコク	にゅうこく、入国
ニューコー	にゅうこう、入こう、入坑、入寇、入校、入構、入港、入行、入貢
ニューゴク	入獄
ニューサツ	入札
ニューザン	にゅうざん、入ざん、入山
ニューシチ	入質
ニューシツ	入室
ニューシャ	にゅうしゃ、入射、入社
ニューシュ	にゅうしゅ、入手
ニューシュツリョク	入出力
ニューショ	にゅうしょ、入所
ニューショク	入植
ニューショー	にゅうしょう、入省、入賞
ニューシン	入信
ニュージャク	入寂
ニュージョー	入城、入場、入定
ニュースイ	入水
ニューセキ	入籍
ニューセン	にゅうせん、入せん、入線、入選
ニューソン	入村
ニュータイ	入隊
ニューダン	入団
ニューチョー	入朝
ニューテイ	入廷
ニューデン	入電
ニュートー	にゅうとう、入党、入湯
ニュードー	にゅうどう、入道
ニューバイ	にゅうばい、入梅
ニューフ	入府
ニューブ	入部
ニューホク	入北
ニューマク	入幕
ニューメツ	にゅうめつ、入滅
ニューモン	にゅうもん、入門
ニューヨク	にゅうよく、入浴
ニューライ	にゅうらい、入来
ニューラク	にゅうらく、入洛
ニューリョク	にゅうりょく、入力
ニューリョー	入寮
ニューロー	にゅうろう、入牢
ニラメッコ	にらめっこ
ニンカ	にんか、認可
ニンカン	にんかん、任官
ニンキョ	認許
ニンク	にんく、忍苦
ニンシキ	にんしき、認識
ニンショー	にんしょう、ニンショウ、認証
ニンシン	にんしん、妊娠
ニンジュ	忍受
ニンジュー	忍従
ニンジョー	にんじょう、刃傷
ニンタイ	にんたい、忍耐
ニンチ	にんち、認知
ニンテイ	にんてい、ニンテイ、認定
ニンメイ	にんめい、任命
ニンメン	任免
ニンヨー	にんよう、任用、認容
ヌイナオシ	縫直し
ヌイモノ	ぬいもの、縫いもの、縫い物、縫物
ヌキサシ	ぬきさし、抜きさし、抜き差、抜き差し、抜差、抜差し
ヌスミドリ	盗み撮り
ネアガリ	ねあがり、ね上がり、ね上り、値上がり、値上り
ネアゲ	ねあげ、値あげ、値上、値上げ
ネグレクト	ネグレクト
ネサガリ	値下がり、値下り
ネサゲ	ねさげ、値下げ
ネッ	熱
ネッキョー	ねっきょう、ねっ狂、熱狂
ネッキング	ネッキング
ネッサン	ねっさん、ねっ賛、熱讚
ネッショー	ねっしょう、ねっ唱、熱唱
ネッチュー	ねっちゅう、ねっ中、熱中
ネッパツ	熱発
ネツアイ	熱愛
ネツエン	熱演
ネツガン	熱願
ネツショリ	熱処理
ネツジューゴー	熱重合
ネツゾー	ねつぞう、ねつ造、捏造
ネツベン	熱弁
ネツボー	熱望
ネトマリ	寝泊まり、寝泊り
ネバネバ	ねばねば、ネバネバ、粘粘
ネビエ	寝冷え
ネビキ	ねびき、ね引、ね引き、値引、値引き
ネブソク	ねぶそく、寝不足
ネマワシ	ねまわし、ね回し、根まわし、根回し
ネライウチ	ねらい撃ち、狙い撃ち
ネンガン	ねんがん、念願
ネンザ	ねんざ、ねん挫、捻挫
ネンシ	ねんし、ねん糸、撚糸
ネンシュツ	ねんしゅつ、ねん出、拈出、捻出
ネンショー	ねんしょう、燃焼
ネンジ	ねんじ、念持
ネンジュ	ねんじゅ、念じゅ、念誦
ネンズ	ねんず、念誦
ネンチャク	ねんちゃく、粘着
ネンテン	ねんてん、ねん転、捻転
ネンブツ	ねんぶつ、念仏
ネーミング	ネーミング
ノジュク	のじゅく、野宿
ノタレジニ	のたれ死に、野垂れ死に、野垂死
ノック	ノック
ノックアウト	ノックアウト
ノッペリ	のっぺり
ノビノビ	のびのび、伸のび、伸びのび、伸び伸び
ノミネート	ノミネート
ノリイレ	乗りいれ、乗り入れ、乗入、乗入れ
ノリオリ	のりおり、乗りおり、乗り下り、乗り降り、乗降り
ノリズケ	のりづけ、のり付、のり付け、ノリ付、ノリ付け、糊づけ、糊付、糊付け
ノーカ	のうか、濃化
ノーカン	のうかん、納棺
ノーキン	納金
ノーコツ	納骨
ノーコー	のうこう、農耕
ノーサツ	悩殺、納札
ノーシ	のうし、脳死
ノーシャ	のうしゃ、納車
ノーシュク	のうしゅく、濃縮
ノージュ	納受
ノーゼイ	のうぜい、納税
ノーニュー	納入
ノーヒン	納品
ノーフ	のうふ、納付
ノーホン	納本
ノーラン	のうらん、悩乱
ノーリョー	のうりょう、納涼
ハアク	はあく、把握
ハイ	廃、拝、排、配
ハイイン	はいいん、配員
ハイエツ	はいえつ、拝謁
ハイカイ	はいかい、徘徊
ハイカン	はいかん、廃刊、拝観、配管
ハイガ	拝賀
ハイガン	はいがん、拝顔
ハイキ	はいき、廃棄、拝跪、排気
ハイキュー	はいきゅう、廃休、配給
ハイキング	ハイキング
ハイギョー	廃業
ハイケン	はいけん、はい見、拝見
ハイゲキ	排撃
ハイコー	はいこう、配向
ハイゴー	はいごう、廃合、配合
ハイサツ	拝察
ハイザイ	配剤
ハイザン	はいざん、はい山、廃ざん、廃山
ハイシ	はいし、廃止、配し
ハイシャ	はいしゃ、はい車、配車
ハイシャク	はいしゃく、拝借
ハイシュツ	はいしゅつ、排出、輩出
ハイショク	配色
ハイショー	はいしょう、拝しょう、拝承
ハイシン	はいしん、配信
ハイジ	はいじ、拝辞
ハイジャック	ハイジャック
ハイジュ	拝受
ハイジョ	はいじょ、排除
ハイスイ	はいすい、排水、配水
ハイスー	はいすう、拝すう、拝趨
ハイセキ	はいせき、排斥
ハイセツ	はいせつ、ハイセツ、排せつ、排泄
ハイセン	はいせん、敗戦、配線
ハイゼツ	廃絶
ハイゼン	はいぜん、ハイゼン、配ぜん、配膳
ハイソ	はいそ、敗訴
ハイソー	はいそう、敗走、背走、配送
ハイゾク	配属
ハイタ	はいた、はい他、排他
ハイタイ	はいたい、はい胎、廃退、廃頽、敗退、胚胎
ハイタツ	はいたつ、配達
ハイチ	はいち、はい置、背ち、背馳、配ち、配置
ハイチャク	廃嫡
ハイチョー	はいちょう、廃朝、拝聴
ハイテイ	はいてい、拝呈
ハイテン	はいてん、配転
ハイデン	はいでん、配電
ハイトー	はいとう、はい当、配当
ハイドク	はいどく、拝読
ハイニョー	排尿
ハイニン	背任
ハイハン	はいはん、悖反、背反、背叛
ハイビ	はいび、拝び、拝眉、配び、配備
ハイフ	はいふ、ハイフ、配付、配布
ハイブン	はいぶん、配分
ハイベン	排便
ハイホン	配本
ハイボク	はいぼく、敗ぼく、敗北
ハイボー	敗亡
ハイメイ	拝命
ハイメツ	廃滅
ハイメン	はいめん、背面
ハイヨー	はいよう、はい用、佩用
ハイラン	はいらん、排卵
ハイラーテン	ハイラーテン
ハイリ	はいり、ハイリ、背離
ハイリツ	廃立
ハイリョ	はいりょ、配慮
ハイリョー	拝領
ハイル	配流
ハイレイ	拝礼
ハイレツ	はいれつ、排列、配列
ハカイ	はかい、破壊
ハガン	はがん、破顔
ハガンイッショー	破顔一笑
ハキ	破棄、破毀
ハキュー	はきゅう、波及
ハギシリ	はぎしり、ハギシリ、歯ぎしり、歯ギシリ
ハク	博、泊
ハクガイ	はくがい、迫害
ハクグー	薄遇
ハクゲキ	迫撃
ハクサイ	はくさい、舶載
ハクシュ	はくしゅ、はく手、拍手
ハクシュカッサイ	拍手かっさい、拍手喝さい
ハクジョー	はくじょう、白状
ハクダク	白濁
ハクダツ	はくだつ、はく奪、はく脱、剥奪、剥脱
ハクチュー	はくちゅう、伯仲
ハクドー	はくどう、はく動、搏動
ハクネツ	はくねつ、白熱
ハクラク	はくらく、はく落、剥落
ハクラン	はくらん、博覧
ハクリ	はくり、はく離、剥離
ハケン	はけん、派遣
ハコー	はこう、は行、跛行
ハゴク	はごく、破獄
ハサイ	はさい、破摧、破砕
ハサン	はさん、破産
ハシカケジューゴー	橋掛け重合
ハシュ	はしゅ、は種、播種
ハシュツ	派出
ハショク	波蝕
ハシリガキ	走り書き、走書き
ハシワタシ	はしわたし、橋わたし、橋渡、橋渡し
ハジ	把持
ハスイ	はすい、破水
ハセイ	はせい、派生
ハソク	はそく、把そく、把捉
ハソン	はそん、破損
ハタアゲ	はたあげ、旗揚げ
ハタン	はたん、破たん、破綻
ハダアレ	はだあれ、肌あれ、肌荒れ
ハダン	はだん、破断
ハチアワセ	はち合わせ、ハチ合わせ、鉢合せ、鉢合わせ
ハチマキ	はちまき、鉢まき、鉢巻、鉢巻き
ハッカ	はっか、はっ火、発火
ハッカイ	はっかい、はっ会、発会
ハッカク	はっかく、はっ覚、発覚
ハッカン	はっかん、はっ刊、はっ汗、はっ艦、発刊、発汗
ハッキ	はっき、発揮
ハッキュー	はっきゅう、はっ給、発給
ハッキョー	はっきょう、はっ狂、発狂
ハッキング	ハッキング
ハックツ	はっくつ、はっ掘、ハックツ、発掘
ハッケン	はっけん、はっ券、はっ見、ハッケン、発券、発見
ハッコン	はっこん、はっ根、発根
ハッコー	はっこう、はっ光、はっ効、はっ向、はっ行、はっ酵、ハッコウ、発こう、発光、発効、発向、発行、発酵、醗酵
ハッサン	はっさん、はっ散、発さん、発散
ハッシャ	はっしゃ、はっ射、はっ車、ハッシャ、発射、発車
ハッシュツ	発出
ハッショク	はっしょく、はっ色、発色
ハッショー	はっしょう、はっ祥、ハッショウ、発症、発祥
ハッシン	はっしん、はっ信、はっ振、はっ進、ハッシン、発しん、発信、発振、発疹、発進
ハッスル	ハッスル
ハッセイ	はっせい、はっ声、はっ生、ハッセイ、発声、発生
ハッセキ	はっせき、はっ赤、発赤
ハッセン	はっせん、はっ船、ハッセン、発船
ハッソク	はっそく、発足
ハッソー	はっそう、はっ走、はっ送、ハッソウ、発そう、発想、発走、発送
ハッタツ	はったつ、はっ達、ハッタツ、発達
ハッチャク	はっちゃく、はっ着、ハッチャク、発着
ハッチュー	はっちゅう、発注
ハッテン	はってん、発展
ハッピョー	はっぴょう、ハッピョウ、発表
ハップ	はっぷ、発布
ハップン	はっぷん、発奮、発憤
ハッポー	はっぽう、発泡、発砲
ハツアン	発案
ハツイ	はつい、発意
ハツイク	はついく、発育
ハツエン	発煙
ハツオン	はつおん、はつ音、ハツオン、発音
ハツガ	はつが、発芽
ハツギ	はつぎ、発議
ハツゲン	はつげん、発現、発言
ハツジョー	発情
ハツダ	はつだ、発兌
ハツデン	はつでん、発電
ハツドー	はつどう、発動
ハツネツ	はつねつ、発熱
ハツバイ	はつばい、発売
ハツビョー	発病
ハツメイ	はつめい、発明
ハツモン	発問
ハツモーデ	はつもうで、初もうで、初詣、初詣で
ハツヨー	発揚
ハツレイ	発令
ハツロ	発露
ハナシ	話
ハナシアイ	はなしあい、話あい、話しあい、話し合い、話合い
ハナミ	はなみ、花見
ハヘイ	はへい、派兵
ハメツ	はめつ、破滅
ハモン	はもん、破門
ハヤオキ	はやおき、ハヤオキ、早おき、早起き
ハヤオクリ	早送り、速送り
ハヤガテン	はやがてん、早合点
ハヤク	はやく、ハヤク、破約
ハヤジニ	早死、早死に
ハヤトチリ	はやとちり、早とちり
ハヤネ	はやね、早寝
ハライサゲ	払い下げ、払下げ
ハライダシ	払いだし、払い出し、払出、払出し
ハライモドシ	払いもどし、払い戻し、払戻し
ハレツ	はれつ、破裂
ハレバレ	はればれ、晴々、晴ばれ、晴れ晴れ、晴晴
ハロー	はろう、破牢
ハン	反
ハンエイ	はんえい、はん栄、反映、繁栄
ハンカイ	はんかい、半壊
ハンキョー	はんきょう、反響
ハンギャク	反逆、叛逆
ハンケツ	はんけつ、判決
ハンゲキ	はんげき、反撃
ハンゲン	はんげん、半減
ハンコー	はんこう、反抗、反攻、版行
ハンサヨー	反作用
ハンシャ	はんしゃ、反射
ハンシュツ	搬出
ハンシュー	半周
ハンショク	はんしょく、繁殖、蕃殖
ハンショー	はんしょう、はん称、半焼、反証、汎称
ハンジ	はんじ、判示
ハンジョー	はんじょう、繁昌、繁盛
ハンスー	はんすう、反すう、反芻
ハンセイ	はんせい、反省
ハンゼイ	はんぜい、反ぜい、反噬
ハンゼン	判然
ハンソ	はんそ、反訴
ハンソク	はんそく、反則、犯則
ハンソー	はんそう、帆走、搬送
ハンタイ	はんたい、反対
ハンダズケ	はんだづけ、半田付け
ハンダン	はんだん、判断
ハンティング	ハンティング
ハンテイ	はんてい、判定
ハンテン	はんてん、反転
ハント	ハント
ハントー	はんとう、反騰
ハンド	ハンド
ハンドク	はんどく、はん読、判読、繙読
ハンドリング	ハンドリング
ハンニュー	搬入
ハンノー	はんのう、反のう、反応
ハンバイ	はんばい、はん売、販売
ハンバク	はんばく、反ばく、反駁
ハンパツ	はんぱつ、反ぱつ、反撥、反発
ハンピレイ	はんぴれい、反ぴ例、反比例
ハンブル	ハンブル
ハンプ	はんぷ、頒ぷ、頒布
ハンプク	はんぷく、反ぷく、反復、反覆
ハンベツ	判別
ハンメイ	はんめい、判明、反命
ハンモ	はんも、繁茂
ハンモク	反目
ハンモン	はんもん、反もん、反問、煩もん、煩悶
ハンヤク	反訳
ハンヨー	はんよう、はん用、汎用
ハンラク	反落
ハンラン	はんらん、はん乱、はん濫、反乱、叛乱、氾濫
ハンロン	反論
バイアス	バイアス
バイイン	ばいいん、売いん、売淫
バイカ	ばいか、倍加
バイカイ	ばいかい、媒介
バイカン	ばいかん、陪観
バイキャク	売却
バイキュー	倍旧
バイシャク	媒妁、媒酌
バイシュン	ばいしゅん、売春、買春
バイシュー	ばいしゅう、買収
バイショク	陪食
バイショー	ばいしょう、賠償
バイジュー	陪従
バイジョー	陪乗
バイセキ	陪席
バイゾー	ばいぞう、倍増
バイチョー	ばいちょう、陪聴
バイバイ	ばいばい、売買
バイヤク	売約
バイヨー	ばいよう、培養
バウンド	バウンド
バク	縛
バクゲキ	ばくげき、ばく撃、バクゲキ、爆撃、駁撃
バクサツ	爆殺
バクシ	ばくし、爆死
バクショ	ばくしょ、ばく書、曝書
バクショー	ばくしょう、爆傷、爆笑
バクシン	ばくしん、ばく進、驀進
バクチン	爆沈
バクハ	ばくは、爆破
バクハツ	ばくはつ、爆発
バクレツ	ばくれつ、爆裂
バクロ	ばくろ、暴露、曝露
バクロン	ばくろん、ばく論、駁論
バコー	ばこう、馬耕
バショク	ばしょく、馬食
バッ	罰
バック	バック
バックアップ	バックアップ
バッケン	ばっけん、ばっ剣、抜剣
バッコ	ばっこ、跋扈
バッサイ	ばっさい、ばっ採、伐採
バッシ	ばっし、ばっ歯、ばっ糸、抜歯、抜糸
バッショー	ばっしょう、ばっ渉、跋渉
バッシング	バッシング
バッスイ	ばっすい、ばっ粋、抜粋、抜萃
バッセン	ばっせん、ばっ染、抜染
バッテキ	ばってき、抜てき、抜擢
バットー	ばっとう、ばっ刀、抜刀
バツビョー	ばつびょう、抜びょう、抜錨
バツボク	伐木
バトンタッチ	バトンタッチ
バトー	ばとう、ば倒、罵倒
バラズミ	ばら積、ばら積み、散積
バリ	ばり、罵詈
バンカイ	ばんかい、ばん回、挽回
バンキョ	ばんきょ、盤きょ、盤踞、蟠踞
バンシャク	ばんしゃく、晩しゃく、晩酌
バンショ	ばんしょ、板書
バンセイ	ばんせい、晩成
バンソー	ばんそう、伴奏
バント	バント
パス	パス
パック	パック
パット	パット
パトロール	パトロール
パラフレーズ	パラフレーズ
パレード	パレード
パワーアップ	パワーアップ
パン	パン
パンク	パンク
パンチ	パンチ
パント	パント
パーク	パーク
パージ	パージ
パーティ	パーティ
ヒ	秘
ヒイキ	ひいき、贔いき、贔屓
ヒエキ	ひえき、ひ益、裨益
ヒエツ	ひえつ、披閲
ヒエビエ	ひえびえ、冷え冷え
ヒカク	ひかく、比較
ヒカリオートー	光応答
ヒカリレイキ	光励起
ヒカン	ひかん、悲観、避寒
ヒガエリ	ひがえり、日帰り
ヒキアゲ	ひきあげ、引き上げ、引き揚げ、引上げ、引揚げ
ヒキアテ	ひきあて、引き当て、引当、引当て
ヒキウケ	ひきうけ、引き受け、引受、引受け
ヒキオトシ	ひきおとし、引き落とし、引落し
ヒキサゲ	ひきさげ、引き下げ、引下げ
ヒキザン	ひきざん、引き算、引算
ヒキダシ	ひきだし、引き出し、引出し
ヒキニゲ	ひき逃げ、轢き逃げ、轢逃げ
ヒギ	誹議、非議
ヒケツ	ひけつ、否決、秘けつ、秘結
ヒケン	ひけん、ひ見、披見、比肩
ヒゲ	卑下
ヒコー	ひこう、披講、肥厚、飛行
ヒゴ	ひご、ひ護、庇護
ヒサイ	ひさい、被災
ヒサン	ひさん、飛さん、飛散
ヒシュー	悲愁
ヒショ	ひしょ、避暑
ヒショー	ひしょう、費消、飛しょう、飛翔
ヒジュン	ひじゅん、批准
ヒセイ	批正
ヒセンコー	非専攻
ヒゾー	秘蔵
ヒタン	ひたん、悲嘆、悲歎
ヒダイ	ひだい、肥大
ヒダン	被弾
ヒッキ	ひっき、ひっ記、筆記
ヒッケン	ひっけん、ひっ見、必見
ヒッコシ	ひっこし、ヒッコシ、引っ越し、引越、引越し
ヒッサン	ひっさん、ひっ算、筆算
ヒッシャ	ひっしゃ、ひっ写、筆写
ヒッソク	ひっそく、逼そく、逼塞
ヒッチャク	ひっちゃく、ひっ着、必着
ヒッチュー	ひっちゅう、ひっ中、必中、筆ちゅう、筆誅
ヒッテキ	ひってき、ひっ敵、匹敵
ヒット	ヒット
ヒットー	ひっとう、ひっ答、筆答
ヒッパク	ひっぱく、ひっ迫、逼迫
ヒツダン	筆談
ヒツドク	必読
ヒテイ	ひてい、否定、比定
ヒトアンシン	ひと安心、一安心
ヒトガンバリ	ひと頑張り、一頑張り
ヒトク	ひとく、秘匿
ヒトクロー	ひとくろう、一苦労
ヒトダンラク	一段落
ヒトチガイ	人ちがい、人違い
ヒトットビ	ひとっ飛び、一飛び
ヒトニタチ	ひと煮立ち、一煮立ち
ヒトネムリ	ひと眠り、一眠り
ヒトヤスミ	ひと休み、一休み
ヒトリアルキ	ひとり歩き、独り歩き、独歩き
ヒトリウラナイ	ひとり占い、独り占い
ヒトリガテン	ひとり合点、独り合点
ヒトリギメ	ひとり決め、独り決め
ヒトリジメ	ひとりじめ、ひとり占め、一人占め、独り占め、独占め
ヒトリダチ	ひとり立ち、独り立ち、独立ち
ヒトリノミコミ	ひとり呑み込み、独り呑み込み
ヒナン	ひなん、批難、避難、非難
ヒニン	ひにん、否認、避妊
ヒハン	ひはん、批判
ヒバイ	肥培
ヒバク	ひばく、被ばく、被曝、被爆
ヒヒョー	ひひょう、批評
ヒフク	ひふく、被覆
ヒフン	悲憤
ヒヘイ	ひへい、疲弊
ヒボー	ひぼう、誹謗
ヒマン	ひまん、肥満
ヒメン	ひめん、罷免
ヒャクシュツ	百出
ヒヤク	ひやく、飛躍
ヒヤケ	ひやけ、日やけ、日焼、日焼け
ヒヤヒヤ	ひやひや、ヒヤヒヤ、冷ひや、冷やひや、冷や冷や
ヒョウヘン	ひょうへん
ヒョー	評
ヒョーカ	ひょうか、評価
ヒョーカイ	氷解
ヒョーキ	ひょうき、標記、表記
ヒョーギ	評議
ヒョーケツ	氷結、票決、表決、評決
ヒョーゲン	ひょうげん、表現
ヒョーシヌケ	拍子ぬけ、拍子抜け
ヒョーシャク	氷釈、評釈
ヒョーシュツ	表出
ヒョーショー	ひょうしょう、表彰、表象
ヒョージ	ひょうじ、標示、表示
ヒョージョー	評定
ヒョーセツ	ひょうせつ、ひょう窃、剽窃
ヒョーソー	ひょうそう、表そう、表装
ヒョーチャク	漂着
ヒョーテイ	ひょうてい、標定、評定
ヒョーハク	ひょうはく、漂泊、漂白、表白
ヒョーヘン	ひょう変、豹変
ヒョーボー	ひょうぼう、標ぼう、標榜
ヒョーメイ	表明
ヒョーリ	表裏
ヒョーリュー	漂流
ヒョーリョー	ひょう量、秤量
ヒョーロン	ひょうろん、評論
ヒヨー	ひよう、飛揚
ヒラアヤマリ	ひらあやまり、平あやまり、平謝り
ヒライ	ひらい、飛来
ヒラテウチ	平手うち、平手打ち
ヒリン	ひりん、賁臨
ヒルイ	ひるい、比類
ヒルネ	ひるね、ひる寝、ヒルネ、昼ね、昼寝
ヒレイ	ひれい、比例
ヒレキ	ひれき、披れき、披瀝
ヒロイヨミ	ひろい読み、拾い読み
ヒロビロ	ひろびろ、ヒロビロ、広々、広びろ、広広
ヒロー	披露、疲労
ヒワレ	ひわれ、干われ、干割れ
ヒン	瀕、貧
ヒンケツ	ひんけつ、貧血
ヒンシュク	ひんしゅく、ヒンシュク、顰蹙
ヒンシュツ	頻出
ヒンセキ	ひんせき、ひん斥、擯斥
ヒンパツ	ひんぱつ、ひん発、頻ぱつ、頻発
ヒンピョー	ひんぴょう、品ぴょう、品評
ビイキ	贔屓
ビカ	美化
ビギン	びぎん、微吟
ビクショー	微苦笑
ビコー	びこう、尾行、微行
ビショク	びしょく、美食
ビショー	びしょう、微笑
ビゾー	びぞう、微増
ビチク	備蓄
ビックリ	びっくり、ビックリ、吃驚
ビドー	びどう、微動
ビバーク	ビバーク
ビブン	びぶん、微分
ビホー	びほう、び縫、弥縫、彌縫
ビマン	びまん、び漫、弥漫、瀰漫
ビョーガ	びょうが、びょう画、描画、病が、病臥
ビョーキ	びょうき、病気
ビョーケツ	病欠
ビョーシ	びょうし、病死
ビョーシャ	描写
ビョーシュツ	描出
ビョーボツ	病歿、病没
ビラン	びらん、び爛、糜らん、糜爛
ビロク	びろく、微ろく、微祿、微禄
ビンサツ	びんさつ、びん察、憫察
ビンショー	びんしょう、びん笑、憫笑
ビンジョー	便乗
ビンボー	びんぼう、貧乏
ビンラン	びんらん、びん乱、紊乱
ピックアップ	ピックアップ
ピッチング	ピッチング
ピレイ	比例
ピンハネ	ピンはね
ピンボケ	ピンぼけ
ピーアール	ＰＲ
フ	付、賦、附
ファイル	ファイル
ファウル	ファウル
ファクス	ファクス
ファックス	ファックス、ＦＡＸ
フィット	フィット
フィードバック	フィードバック
フイク	ふいく、ふ育、傅育、扶育、覆育
フイチョー	ふいちょう、ふい聴、吹ちょう、吹聴
フェッチ	フェッチ
フェラチオ	フェラチオ
フエン	ふえん、布衍、敷えん、敷衍
フォトエッチング	フォトエッチング
フォロー	フォロー
フォースアウト	フォースアウト
フォール	フォール
フォールガチ	フォール勝ち
フカ	ふか、ふ化、付加、付課、孵化、負荷、賦課、附加
フカイ	付会、附会
フカイリ	深入、深入り
フカツ	ふかつ、賦活
フカヨイ	深酔、深酔い
フカン	ふかん、俯かん、俯瞰
フキ	ふき、付記、附記
フキカエ	ふきかえ、吹き替え、吹替え
フキュー	ふきゅう、普及、腐朽
フキョー	ふきょう、布教
フギ	付議、附議
フク	伏、復
フクイ	ふくい、復位
フクイン	ふくいん、復員
フクエキ	服役
フクエン	ふくえん、復円、復縁
フクカン	ふくかん、復刊
フクガ	ふくが、伏が、伏臥
フクガク	復学
フクギョー	復業
フクゲン	ふくげん、復元、復原
フクゴー	ふくごう、復号
フクザイ	伏在、服罪
フクシャ	ふくしゃ、ふく写、ふく射、複しゃ、複写、輻射
フクシュー	ふくしゅう、復しゅう、復習、復讎、復讐
フクショ	副署
フクショク	復職
フクショー	ふくしょう、復しょう、復唱、復誦
フクシン	ふくしん、覆審
フクジュー	ふくじゅう、服従
フクセイ	ふくせい、復姓、複製
フクセキ	復籍
フクソー	ふくそう、副葬、輻そう、輻湊、輻輳
フクゾク	服属
フクチョー	ふくちょう、復調
フクドク	服毒
フクヘキ	ふくへき、復へき、復辟
フクボツ	覆没
フクム	服務
フクメイ	復命
フクメツ	覆滅
フクメン	ふくめん、覆面
フクモ	ふくも、服喪
フクヤク	服薬
フクヨー	ふくよう、服よう、服用、服膺
フクリュー	ふくりゅう、伏流
フゲン	付言、附言
フコク	ふこく、布告
フゴー	ふごう、符合
フサン	ふさん、不参
フショク	ふしょく、扶植、腐しょく、腐蝕、腐食
フショー	ふしょう、不承、負傷
フシン	ふしん、普請、腐心
フジチャク	不時着
フジユー	ふじゆう、不自由
フジョ	ふじょ、ふ助、扶じょ、扶助
フジョー	ふじょう、浮上
フジン	ふじん、布陣
フズイ	ふずい、付随、附随
フセ	伏せ
フセキ	ふせき、布石
フセツ	付設、布設、敷設、附設
フセン	ふせん、布線
フソク	ふそく、不足
フゾク	ふぞく、付属、附属
フタイ	ふたい、付帯、附帯
フタク	ふたく、付託、負託、附託
フタツ	ふたつ、布達
フタン	ふたん、負担
フチ	付置、布置、扶持、附置
フチャク	ふちゃく、付着、附着
フッカツ	ふっかつ、ふっ活、復活
フッカン	ふっかん、ふっ刊、復かん、復刊
フッキ	ふっき、ふっ帰、復帰
フッキュー	ふっきゅう、ふっ旧、復仇、復旧
フックリ	ふっくり
フッケン	ふっけん、ふっ権、復権
フッコ	ふっ古、復古
フッコク	ふっこく、ふっ刻、復刻、覆刻
フッコー	ふっこう、復こう、復交、復興、復航
フッシキ	ふっしき、払しき、払拭
フッショク	ふっしょく、払しょく、払拭
フッテイ	ふってい、ふっ底、払底
フットー	ふっとう、ふっ騰、沸とう、沸騰
フドー	ふどう、浮動
フナデ	ふなで、舟出、船出
フニン	ふにん、赴任
フハイ	ふはい、腐敗
フユー	ふゆう、浮游、浮遊
フヨ	付与、賦与、附与
フヨク	ふよく、扶翼
フヨー	ふよう、扶養、浮揚
フヨーカ	不溶化
フライング	フライング
フラッシュ	フラッシュ
フラン	ふらん、ふ卵、腐らん、腐乱、腐爛
フリコミ	ふりこみ、フリコミ、振りこみ、振り込、振り込み、振込、振込み
フリュー	ふりゅう、浮流
フリン	ふりん、不倫
フルスイング	フルスイング
フルモデルチェンジ	フルモデルチェンジ
フロク	ふろく、付録、附録
フロー	ふろう、浮浪
フロート	フロート
フワライドー	付和雷同、附和雷同
フン	扮
フンカ	ふんか、噴火
フンガイ	ふんがい、憤慨
フンキ	ふんき、奮起
フンキュー	ふんきゅう、紛きゅう、紛糾
フンギ	紛議
フンゲキ	憤激
フンコツサイシン	粉骨砕身
フンゴー	ふんごう、ふん合、吻合
フンサイ	ふんさい、粉砕
フンシ	ふんし、憤死
フンシツ	紛失
フンシャ	噴射
フンシュツ	噴出
フンショク	粉食、粉飾
フンジョー	紛擾
フンセン	ふんせん、奮戦
フンソー	ふんそう、ふん装、扮装、紛争
フントー	ふん闘、奮闘
フンド	ふんど、フンド、忿怒、憤怒
フンパツ	ふんぱつ、奮ぱつ、奮発
フンベツ	ふんべつ、分別
フンラン	紛乱
フンリン	ふんりん、ふん臨、賁臨
フンレイ	奮励
フーイン	ふういん、封印
フーエイ	諷詠
フーカ	ふうか、風化
フーカン	ふうかん、封かん、封緘、諷諌
フーキリ	封切、封切り
フーサ	ふうさ、封鎖
フーサツ	封殺
フーシ	ふうし、ふう刺、諷刺、風刺
フーショウ	ふうしょう
フーショク	風蝕、風食
フーショー	ふう誦、諷しょう、諷誦
フージュ	ふうじゅ、諷誦
フーニュー	封入
フーハツ	風発
フービ	ふうび、風び、風靡
フーブン	風聞
フーユ	ふうゆ、ふう諭、諷諭、風諭
ブイク	ぶいく、ぶ育、撫育
ブギョー	ぶぎょう、奉行
ブコク	ぶこく、ぶ告、誣告
ブシン	普請
ブジョク	ぶじょく、侮辱
ブソク	不足
ブソー	ぶそう、武装
ブチ	扶持
ブッコ	ぶっこ、ぶっ故、物故
ブッサン	ぶっさん、ぶっ参、仏参
ブッショク	ぶっしょく、ぶっ色、物色
ブツギリ	ぶつ切り
ブツノー	物納
ブツブツコーカン	ぶつぶつ交換、物々交換、物物交換
ブトー	ぶとう、舞踏
ブベツ	ぶべつ、侮べつ、侮蔑
ブラウザチェック	ブラウザチェック
ブラッシング	ブラッシング
ブリッジ	ブリッジ
ブレンド	ブレンド
ブレーク	ブレーク
ブロッキング	ブロッキング
ブン	分
ブンエン	ぶんえん、分煙
ブンカ	ぶんか、分化
ブンカイ	ぶんかい、分界、分解
ブンカツ	ぶんかつ、分割、分轄
ブンキ	ぶんき、分岐
ブンキョク	分極
ブンギョー	分業
ブンケ	ぶんけ、分家
ブンケツ	ぶんけつ、分けつ、分蘖
ブンケン	分遣
ブンコツ	分骨
ブンコー	ぶんこう、分光
ブンゴー	ぶんごう、分合
ブンサツ	分冊
ブンサン	ぶんさん、分散
ブンシュク	分宿
ブンショク	文飾
ブンショー	ぶんしょう、分掌
ブンジョー	分乗、分譲
ブンスイ	ぶんすい、分水
ブンセキ	ぶんせき、分析
ブンセツ	分節
ブンセン	ぶんせん、文選
ブンソン	分村
ブンタン	ぶんたん、分担
ブンダン	ぶんだん、分断
ブンチ	ぶんち、分地、聞知
ブンツー	文通
ブンノー	分納
ブンバイ	分売
ブンパ	ぶんぱ、分ぱ、分派
ブンパイ	ぶんぱい、分ぱい、分配
ブンピ	ぶんぴ、分泌
ブンピツ	ぶんぴつ、ぶん筆、分ぴつ、分泌、分筆
ブンプ	ぶんぷ、分ぷ、分布
ブンプク	分ぷく、分服
ブンベツ	ぶんべつ、分別
ブンベン	ぶんべん、分べん、分娩
ブンポー	分包、分封
ブンユー	ぶんゆう、分有
ブンヨ	ぶんよ、分与
ブンラン	ぶんらん、ぶん乱、紊乱
ブンリ	ぶんり、分離
ブンリツ	分立
ブンリュー	ぶんりゅう、分りゅう、分流、分溜、分留
ブンルイ	ぶんるい、分類
ブンレツ	ぶんれつ、分列、分裂
プッシュ	プッシュ
プランニング	プランニング
プリント	プリント
プレス	プレス
プレゼン	プレゼン
プレゼント	プレゼント
プレッシング	プレッシング
プレー	プレー
プレーニング	プレーニング
プログラミング	プログラミング
プログラム	プログラム
プロット	プロット
プロテクト	プロテクト
プロテスト	プロテスト
プロデュース	プロデュース
プロポーズ	プロポーズ
プロモート	プロモウト
プール	プール
ヘイイン	へいいん、閉院
ヘイエイ	併営
ヘイカ	へいか、併科
ヘイカイ	へいかい、閉会
ヘイカン	へいかん、閉館
ヘイガ	へいが、平が、平臥
ヘイガン	併願
ヘイキ	へいき、併記
ヘイキョ	閉居
ヘイキン	へいきん、平均
ヘイギョー	閉業
ヘイケイ	閉経
ヘイゲイ	へいげい、睥睨
ヘイコー	へいこう、並行、併行、平行、平衡、閉口、閉校
ヘイゴー	へいごう、併合
ヘイサ	へいさ、閉鎖
ヘイサイ	併催
ヘイザン	へいざん、閉ざん、閉山
ヘイシ	へい止、へい死、斃死、閉止
ヘイシュツ	へい出、併出、迸出
ヘイショー	並称、併称
ヘイシン	へいしん、並進、併進
ヘイシンテイトー	平身低頭
ヘイジョ	平叙
ヘイジョー	へいじょう、閉場
ヘイセツ	併設
ヘイソク	へいそく、へい息、屏息、閉そく、閉塞
ヘイソン	並存、併存
ヘイソー	併走
ヘイチ	へいち、並置、併置
ヘイテイ	平定、閉廷
ヘイテン	へいてん、閉店
ヘイドク	併読
ヘイドン	へいどん、併どん、併呑
ヘイニン	併任
ヘイハツ	併発
ヘイフク	平伏、平復
ヘイブン	平分
ヘイホー	へいほう、平方
ヘイマク	閉幕
ヘイモン	閉門
ヘイユ	へいゆ、平癒
ヘイユー	併有
ヘイヨー	へいよう、併用
ヘイリツ	並立
ヘイレツ	並列
ヘイロク	へいろく、併録
ヘキエキ	へきえき、へき易、辟易
ヘキカイ	へきかい、へき開、劈開
ヘキショ	壁書
ヘン	偏
ヘンアイ	偏愛
ヘンアツ	変圧
ヘンイ	へんい、偏い、偏倚、変位、変異、変移
ヘンカ	へんか、変化
ヘンカイ	へんかい、変改
ヘンカク	へんかく、変革
ヘンカン	へんかん、変換、返還
ヘンキ	へんき、偏奇
ヘンキャク	へんきゃく、返却
ヘンキョク	編曲
ヘンキン	へんきん、返金
ヘンケイ	へんけい、変型、変形
ヘンゲ	変化
ヘンコー	へんこう、偏向、変更
ヘンサイ	へんさい、返済
ヘンサン	へんさん、編さん、編纂
ヘンザイ	へんざい、偏在、遍在
ヘンシ	へんし、変死
ヘンシツ	変質
ヘンシュー	へんしゅう、ヘンシュウ、編修、編輯、編集
ヘンショク	へんしょく、偏食、変色
ヘンショー	へんしょう、返照
ヘンシン	へんしん、偏心、変心、変身、変針
ヘンジ	へんじ、返事、返辞
ヘンジョー	へんじょう、返上
ヘンセイ	へんせい、変成、編制、編成
ヘンセツ	へんせつ、変せつ、変節、変説
ヘンセン	へんせん、変せん、変遷
ヘンソク	変速
ヘンソー	へんそう、変奏、変装、返送
ヘンゾー	変造
ヘンタイ	へんたい、変態
ヘンチョー	へんちょう、偏重、変調
ヘンツー	変通
ヘンテン	へんてん、変転
ヘントー	へんとう、返答
ヘンドー	へんどう、変動
ヘンニュー	編入
ヘンノー	へんのう、返納
ヘンパイ	へんぱい、返ぱい、返杯、返盃
ヘンピン	へんぴん、返ぴん、返品
ヘンプ	へんぷ、返ぷ、返付、返附
ヘンボー	へんぼう、変ぼう、変貌
ヘンポン	へんぽん、返ぽん、返本
ヘンポー	へんぽう、返ぽう、返報
ヘンマン	遍満
ヘンメイ	変名
ヘンヤク	変約
ヘンヨー	へんよう、変容
ヘンレイ	へんれい、返戻、返礼
ヘンレキ	へんれき、遍歴
ベキジョー	べき乗
ベッキ	べっき、べっ記、別記
ベッキョ	べっきょ、べっ居、別居
ベッケ	べっけ、べっ家、別家
ベッケイ	べっけい、べっ掲、別掲
ベッケン	べっ見、瞥見
ベッシ	べっし、べっ視、蔑視
ベッソー	べっそう、べっ送、別送
ベッチ	べっち、べっ置、別置
ベッチュー	別注
ベップー	べっぷう、別封
ベツゲン	別言
ベツノー	別納
ベツバイ	別売
ベンカイ	べんかい、弁解
ベンガク	勉学
ベンキョー	べんきょう、勉強
ベンゴ	べんご、弁護
ベンサイ	べんさい、弁済
ベンショー	弁償
ベンソ	べんそ、弁そ、弁疏
ベンタツ	べんたつ、鞭たつ、鞭撻
ベンナン	弁難
ベンバク	弁駁
ベンパク	べんぱく、弁ぱく、弁駁
ベンピ	べんぴ、便ぴ、便秘
ベンベツ	弁別
ベンメイ	弁明
ベンレイ	勉励
ベンロン	弁論
ペイ	ペイ
ペッティング	ペッティング
ペースト	ペースト
ホ	補
ホイク	ほいく、ほ育、保育、哺育
ホオン	保温
ホカク	ほかく、捕獲
ホカン	ほかん、保管、補完、補間
ホガイ	ほがい、補外
ホキ	補記
ホキュー	ほきゅう、補給
ホキョー	ほきょう、補強
ホキン	保菌
ホクジョー	北上
ホクメン	北面
ホケツ	ほけつ、補血
ホコー	ほこう、歩行、補講
ホゴ	保護
ホサ	ほ佐、補佐、輔佐
ホサク	補作
ホサツ	ほさつ、補殺
ホシャク	保釈
ホシュ	ほしゅ、保守
ホシュー	ほしゅう、補修、補習
ホショク	捕食、補職
ホショー	ほしょう、保証、保障、補償
ホジ	保持
ホジュー	補充
ホジョ	ほじょ、補じょ、補助
ホスト	ホスト
ホセイ	ほせい、補整、補正
ホゼン	ほぜん、保全
ホソク	捕そく、捕捉、歩測、補そく、補足
ホソー	ほそう、舗装、鋪装
ホゾン	ほぞん、保存
ホッ	欲
ホッキ	ほっき、ほっ起、発起
ホッシン	ほっしん、ほっ心、発心、発疹
ホッソク	ほっそく、発足
ホップ	ホップ
ホツガン	発願
ホツギ	ほつぎ、発議
ホテイ	ほてい、補てい、補綴
ホテツ	ほてつ、補てつ、補綴
ホテン	ほてん、補てん、補填
ホドー	ほどう、補導、輔導
ホニュー	ほ乳、哺乳
ホニン	補任
ホネヤスメ	骨休め
ホバク	捕縛
ホヒツ	補ひつ、補弼、補筆、輔弼
ホフク	ほふく、匍匐
ホユー	保有
ホヨー	ほよう、保養
ホリュー	ほりゅう、保留
ホロヨイ	ほろよい、ほろ酔い、ホロヨイ、ホロ酔い、微酔い
ホンアン	翻案
ホンイ	ほんい、翻意
ホンコク	ほんこく、翻刻
ホンシュツ	奔出
ホンシン	翻身
ホンソー	ほんそう、奔走
ホントー	奔騰
ホンナオシ	本直し
ホンプク	ほんぷく、ほん復、本ぷく、本復
ホンマツテントー	本末転倒
ホンヤク	ほんやく、ほん訳、翻訳
ホンユー	本有
ホンロー	ほんろう、ホンロウ、翻ろう、翻弄
ホンワカ	ホンワカ
ホーアン	ほうあん、奉安
ホーイ	ほうい、包囲
ホーエイ	ほうえい、放映、訪英
ホーオー	ほうおう、訪欧
ホーカ	ほうか、ほう下、ホウカ、放か、放下、放歌、放火
ホーカイ	ほうかい、崩壊、崩潰、抱懐
ホーカツ	包括
ホーカムリ	ほおかむり、頬かむり、頬被、頬被り
ホーカン	ほうかん、ホウカン、奉還、訪韓
ホーガ	ほうが、ほう芽、奉が、奉加、奉賀、萌芽
ホーガン	ほうがん、包含
ホーキ	ほうき、ほう起、抛棄、放棄、蜂起
ホーギョ	ほうぎょ、崩御
ホーギン	放吟
ホーケン	ほうけん、奉献
ホーゲ	ほうげ、放下
ホーゲイ	奉迎
ホーゲキ	ほうげき、砲撃
ホーゲン	ほうげん、放言
ホーコク	ほうこく、報告、奉告
ホーコー	ほうこう、ほう公、咆哮、奉こう、奉公、彷こう、彷徨、放校
ホーゴー	ほうごう、抱合、縫合
ホーサイ	ほうさい、報さい、報祭、報賽
ホーサン	奉讃、奉賛、放散
ホーシ	ほうし、奉し、奉仕、奉伺、奉祀
ホーシャ	ほうしゃ、報謝、放射
ホーシュク	奉祝
ホーシュツ	ほうしゅつ、放出
ホーショク	ほうしょく、奉職、飽食
ホーショー	ほうしょう、報償、報奨、奉唱
ホーシン	ほうしん、放心、放神
ホージ	ほう持、捧持、榜示
ホージュク	豊熟
ホージョ	ほうじょ、ほう助、幇助
ホースイ	ほうすい、放水
ホーセイ	ほうせい、縫製
ホーセツ	ほうせつ、包摂
ホーセン	ほうせん、奉遷
ホーソ	訪ソ
ホーソー	ほうそう、包装、奉送、放そう、放送
ホーゾー	ほうぞう、包蔵
ホータイ	ほうたい、包たい、包帯、奉たい、奉戴、訪台
ホーダン	ほうだん、放談
ホーチ	ほうち、報知、放置
ホーチク	放逐
ホーチャク	ほうちゃく、ほう着、逢着
ホーチュー	ほうちゅう、訪中
ホーチョー	ほうちょう、放鳥、訪朝
ホーテイ	ほうてい、ほう呈、奉呈、捧呈
ホーテキ	ほうてき、抛擲、放てき、放擲
ホーテン	ほうてん、奉てん、奉奠
ホーデン	ほうでん、放電
ホートー	ほうとう、ほう答、奉とう、奉答、放とう、放蕩
ホードク	ほう読、奉読、捧読、訪独
ホードー	ほうどう、報道
ホーニチ	訪日
ホーニョー	放尿
ホーニン	放任
ホーネツ	放熱
ホーネン	ほうねん、放念
ホーノー	ほうのう、奉納
ホーハイ	ほうはい、奉拝
ホーバツ	放伐
ホーヒ	ほうひ、ほう屁、放ひ、放屁
ホーフク	ほうふく、報復
ホーフツ	ほうふつ、彷彿、訪仏、髣髴
ホーヘン	ほうへん、ほう貶、褒へん、褒貶
ホーベイ	訪米
ホーボク	ほうぼく、放牧
ホーマン	ほうまん、飽満
ホームステイ	ホームステイ
ホーメン	ほうめん、放免
ホーモン	ほうもん、訪問
ホーヤク	邦訳
ホーヨー	ほうよう、包容、抱擁
ホーラク	ほうらく、崩落
ホーリュー	ほうりゅう、放流
ホールアウト	ホールアウト
ホーロ	ほうろ、訪露
ホーロー	放浪
ホーワ	ほうわ、飽和
ボイコット	ボイコット
ボイル	ボイル
ボウコウ	奉公
ボキン	ぼ金、募金
ボク	卜
ボクサツ	撲殺
ボクシュ	墨守
ボクショ	ぼくしょ、墨書
ボクメツ	ぼくめつ、撲滅
ボサイ	募債
ボサン	ぼさん、墓参
ボシュー	ぼしゅう、募集
ボッ	没
ボッキ	ぼっき、ぼっ起、勃起
ボッキャク	ぼっきゃく、ぼっ却、没却
ボッキョ	ぼっきょ、ぼっ居、卜居
ボッコー	ぼっこう、ぼっ興、勃興
ボッシュ	ぼっしゅ、没取
ボッシュー	ぼっしゅう、ぼっ収、没収
ボットー	ぼっとう、ぼっ頭、没頭
ボッパツ	ぼっぱつ、ぼっ発、勃発
ボツニュー	没入
ボツラク	没落
ボディーペインティング	ボディーペインティング
ボヘイ	募兵
ボンタイ	凡退
ボンディング	ボンディング
ボンヤリ	ぼんやり
ボーアツ	ぼうあつ、ぼう遏、暴あつ、暴圧、防あつ、防遏
ボーアンキ	棒暗記、棒諳記
ボーイン	ぼういん、暴飲
ボーエイ	ぼうえい、防衛
ボーエキ	ぼうえき、貿易、防疫
ボーオン	ぼうおん、防音
ボーカン	ぼうかん、傍観、防寒
ボーガイ	ぼうがい、妨害、妨碍
ボーキャク	忘却
ボーギ	謀議
ボーギョ	ぼうぎょ、ボウギョ、防ぎょ、防御、防禦
ボーケン	ぼうけん、冒険、剖検、望見
ボーゲン	ぼうげん、ボーゲン、暴言
ボーコー	暴行
ボーゴ	ぼうご、防護
ボーサイ	ぼうさい、防災
ボーサツ	忙殺、謀殺
ボーシ	ぼうし、暴死、防止
ボーシツ	ぼうしつ、亡失、忘失
ボーシュク	防縮
ボーショク	ぼうしょく、暴食
ボーショー	ぼうしょう、傍証
ボージュ	傍受
ボースイ	ぼうすい、防水
ボーセン	ぼうせん、防戦
ボーソー	ぼうそう、暴走
ボーダイ	ぼうだい、ぼう大、膨大
ボーチョウ	膨ちょう
ボーチョー	ぼうちょう、ぼう聴、傍ちょう、傍聴、膨張、膨脹
ボートク	ぼうとく、ぼう涜、冒とく、冒涜
ボートー	ぼうとう、暴騰
ボーハツ	暴発
ボーヒョー	ぼう評、妄評
ボービ	ぼうび、防備
ボーホン	ぼうほん、ぼう反、ぼう叛、謀ほん、謀反、謀叛
ボーメイ	亡命
ボーラク	ぼうらく、暴落
ボーリング	ボーリング
ポア	ポア
ポッポ	ぽっぽ、ポッポ
ポーズ	ポーズ
マイキョ	枚挙
マイコツ	埋骨
マイシン	まいしん、まい進、邁進
マイセツ	埋設
マイソー	まいそう、埋葬
マイゾー	まいぞう、埋蔵
マイニング	マイニング
マイノー	まいのう、埋納
マイフク	埋伏
マイボツ	埋没
マインドコントロール	マインドコントロール
マエウリ	前売、前売り
マエオキ	まえおき、前おき、前置き
マエガシ	前貸し
マエガリ	前借り
マエダオシ	前倒し
マエバライ	前払、前払い
マエブレ	まえぶれ、前ぶれ、前触れ
マガリ	まがり、間借、間借り
マサツ	まさつ、摩擦
マスイ	ますい、麻酔
マスタ	マスタ
マスター	マスター
マスターベーション	マスターベーション
マソン	まそん、摩損、磨損
マチビラキ	まちびらき、街びらき、街開き
マッサツ	まっさつ、まっ殺、抹殺
マッサージ	マッサージ
マッショー	まっしょう、まっ消、抹消
マッタ	まった、マッタ、待った
マッチ	マッチ
マッチング	マッチング
マットー	まっとう、全う
マッピング	マッピング
マネ	まね、真似
マノビ	まのび、間のび、間延び
マバタキ	まばたき、マバタキ、瞬き
マヒ	まひ、マヒ、麻ひ、麻痺
マメツ	まめつ、摩滅、磨滅
マモー	まもう、摩耗、磨耗
マルノミ	まるのみ、丸のみ
マワリミチ	まわり路、まわり道、回り路、回り道
マンエツ	まんえつ、満悦
マンエン	まんえん、まん延、蔓延
マンキツ	まんきつ、満喫
マンギン	漫吟
マンサイ	まんさい、満載
マンシン	まんしん、慢心
マンスイ	満水
マンゾク	まんぞく、満ぞく、満足
マンダン	まんだん、漫談
マンチャク	まんちゃく、まん着、瞞着
マンネリカ	マンネリ化
マンバ	まんば、まん罵、慢ば、慢罵、漫ば、漫罵
マンビキ	まんびき、万引、万引き
マンピョー	まんぴょう、まん評、漫ぴょう
マンプク	まんぷく、満ぷく、満腹
マンポ	まんぽ、まん歩、マンポ、漫ぽ、漫歩
マンユー	まんゆう、漫遊
マンリョー	まんりょう、満了
マーク	マーク
ミ	魅
ミアイ	みあい、み合、み合い、見あい、見合、見合い
ミウゴキ	みうごき、み動き、身動き
ミエカクレ	みえかくれ、見えかくれ、見え隠れ、見隠れ
ミオトリ	見劣り
ミカイ	みかい、味解
ミカタ	みかた、み方、味方
ミキキ	みきき、み聞き、見聞き
ミジタク	みじたく、身じたく、身支度
ミス	ミス
ミズアライ	水あらい、水洗い
ミズマシ	水増し
ミセジマイ	店じまい
ミセバン	みせばん、店番
ミチアンナイ	みちあんない、道あんない、道案内
ミッカイ	みっかい、みっ会、密会
ミックス	ミックス
ミッコク	みっこく、みっ告、密告
ミッコー	みっこう、みっ航、みっ行、密航、密行
ミッサツ	みっさつ、みっ殺、密殺
ミッシュー	みっしゅう、みっ集、密集
ミッショク	密植
ミッセイ	みっせい、みっ生、密生
ミッセツ	みっせつ、みっ接、密せつ、密接
ミッソ	みっそ、みっ訴、密訴
ミッソー	みっそう、みっ葬、みっ送、密奏、密葬、密送
ミッチャク	みっちゃく、みっ着、密着
ミッツー	みっつう、みっ通、密通
ミップー	みっぷう、みっ封、密ぷう、密封
ミッペイ	みっぺい、みっ閉、密ぺい、密閉
ミツゾー	みつぞう、密造
ミツダン	密談
ミツバイ	密売
ミツモリ	みつもり、み積、見積、見積もり、見積り
ミツヤク	密約
ミツユ	みつゆ、密輸
ミツユニュー	密輸入
ミツリョー	みつりょう、密漁、密猟
ミトク	みとく、味得
ミトー	みとう、味到
ミドク	みどく、味読
ミナミマワリ	南回り
ミバエ	みばえ、み栄え、見ばえ、見栄え
ミブルイ	身ぶるい、身震い
ミマイ	みまい、み舞、見まい、見舞、見舞い
ミマネ	みまね、見まね、見マネ
ミミウチ	みみうち、耳うち、耳打ち
ミャクドー	脈動
ミリョー	みりょう、魅了
ミワク	魅惑
ミンパク	みんぱく、民泊
ミーティング	ミーティング
ミート	ミート
ムカムカ	むかむか、ムカムカ
ムサン	むさん、霧散
ムシ	無視
ムシン	むしん、無心
ムジュン	むじゅん、矛盾
ムソー	むそう、夢想
ムダズカイ	むだづかい、むだ遣い、無駄遣い
ムチャ	むちゃ、無茶
ムナサワギ	むなさわぎ、胸さわぎ、胸騒ぎ
ムネアゲ	むねあげ、棟上げ
ムリジー	無理強い
メイ	冥
メイキ	めいき、明記、銘記
メイク	メイク
メイゲン	めいげん、明言
メイゴ	めいご、めい護、冥護
メイサツ	めいさつ、明察
メイシャ	鳴謝
メイジ	めいじ、明示
メイジョー	名状
メイソー	めいそう、めい想、瞑想、迷走
メイダン	明断
メイチュー	めいちゅう、命中
メイテイ	めいてい、酩酊
メイトー	めいとう、明答
メイドー	めいどう、鳴動
メイブンカ	明文化
メイメイ	命名
メイメツ	明滅
メイモク	めいもく、めい目、瞑目
メイレイ	めいれい、命令
メウツリ	目うつり、目移、目移り
メジルシ	めじるし、目じるし、目印
メッキ	めっき、メッキ、滅金、鍍金
メッキャク	めっきゃく、めっ却、滅却
メッキン	めっきん、めっ菌、滅菌
メッシツ	めっしつ、めっ失、滅失
メツジン	滅尽
メツボー	めつぼう、滅ぼう、滅亡
メベリ	目減、目減り
メモ	メモ
メモリズケ	目盛付、目盛付け
メンカイ	めんかい、面会
メンカン	めんかん、免官
メンキツ	面詰
メンキョ	めんきょ、免許
メンゴ	めんご、めん晤、めん語、面ご、面晤、面語
メンショク	免職
メンジョ	めんじょ、免除
メンセキ	めんせき、免責、面責
メンセツ	めんせつ、面接
メンゼイ	免税
メンソ	めんそ、免租、免訴
メンダン	面談
メンバ	めんば、面ば、面罵
メーキャップ	メーキャップ
メークアップ	メークアップ
メール	メール
モ	模
モギ	模擬
モクゲキ	もくげき、目撃
モクサツ	黙殺
モクサン	もくさん、目算
モクザ	黙坐、黙座
モクシ	もくし、目指、黙止、黙視
モクソク	目測
モクソー	もくそう、目送、黙想
モクダク	黙諾
モクト	もくと、目と、目睹
モクトー	もくとう、黙とう、黙祷
モクドク	もくどく、黙読
モクニン	黙認
モクヒ	もくひ、黙秘
モクヨク	もくよく、もく浴、沐浴
モクレイ	目礼、黙礼
モサク	もさく、摸索、模作、模索
モシャ	もしゃ、も写、摸写、模写
モゾー	もぞう、も造、摸造、模造
モチニゲ	持ち逃げ
モチハコビ	もちはこび、もち運び、持ちはこび、持ち運び
モッカ	もっか、もっ過、黙過
モッキョ	もっきょ、もっ許、黙許
モッコー	もっこう、もっ考、黙考
モデルチェンジ	モデルチェンジ
モトウケ	元請、元請け
モトジメ	もとじめ、元締、元締め
モニタ	モニタ
モノゴイ	ものごい、物ごい、物乞い
モホー	もほう、摸倣、模倣
モヤモヤ	もやもや
モライナキ	もらい泣き、貰い泣き、貰泣き
モリ	守
モンザイ	問罪
モンシ	もんし、もん死、悶死
モンシン	もんしん、問診
モンセキ	問責
モンゼツ	もんぜつ、もん絶、悶絶
モンゼンバライ	門前払い
モンタージュ	モンタージュ
モンチャク	もんちゃく、悶着
モンドー	もんどう、もん答、問どう、問答
モンバン	もんばん、門番
モーアイ	もうあい、盲愛
モーゲキ	猛撃
モーコー	もうこう、猛攻
モーシュー	猛襲
モーシン	もうしん、妄信、猛進、盲信、盲進
モージュー	もうじゅう、盲従
モージン	もうじん、蒙塵
モーセイ	もうせい、猛省
モーソー	もうそう、妄想
モーツイ	もうつい、猛追
モードー	もうどう、妄動、盲動
モーバク	盲爆
モーヒョー	もうひょう、もう評、妄ひょう、妄評
モーラ	もうら、網羅
モーロク	もうろく、耄碌
ヤエイ	やえい、夜営、野営
ヤオチョー	やおちょう、八百長
ヤキツケ	焼き付け、焼付、焼付け
ヤキナオシ	焼きなおし、焼き直、焼き直し、焼直、焼直し
ヤキモキ	やきもき
ヤキン	やきん、夜勤
ヤクゲン	やくげん、約言
ヤクサイ	やくさい、訳載
ヤクサツ	やくさつ、やく殺、扼殺、薬殺
ヤクシュツ	訳出
ヤクシン	やくしん、躍進
ヤクジュツ	訳述
ヤクジョー	やくじょう、約定
ヤクソク	やくそく、約束
ヤクゾー	躍増
ヤクダク	約諾
ヤクドク	やくどく、訳読
ヤクドー	やくどう、躍動
ヤクブン	約分
ヤクワン	やくわん、やく腕、扼腕
ヤケド	やけど、ヤケド、火傷
ヤゴー	野合
ヤシュー	やしゅう、夜襲
ヤスウリ	やすうり、安売り
ヤセイ	やせい、野生
ヤッカイ	やっ解、訳解
ヤッサモッサ	やっさもっさ
ヤマクズレ	山くずれ、山崩、山崩れ
ヤマズミ	やまづみ、山積、山積み
ヤマノボリ	やまのぼり、やま登、山のぼり、山登、山登り
ヤマモリ	やまもり、山もり、山盛、山盛り
ヤマワケ	やまわけ、山わけ、山分、山分け
ヤミトリヒキ	やみ取引、闇取引
ヤユ	やゆ、揶揄、邪揄
ヤリクリ	やりくり、やり繰り、遣り繰り
ヤリトリ	やりとり、やり取り、遣り取り
ユイゴン	ゆいごん、遺言
ユエツ	ゆえつ、愉悦
ユキキ	往き来、行き来、行来
ユギョー	ゆぎょう、遊行
ユケツ	ゆけつ、輸血
ユコク	諭告
ユゴー	ゆごう、癒合
ユシュツ	ゆしゅつ、輸出
ユセン	ゆせん、湯せん、湯煎
ユソー	ゆそう、輸送
ユダン	ゆだん、油断
ユチャク	ゆ着、癒着
ユドーシ	湯どおし、湯通し
ユニュー	ゆにゅう、輸入
ユライ	由来
ユー	有
ユーイン	ゆういん、誘引
ユーエイ	ゆうえい、游泳、遊泳
ユーエキ	ゆうえき、ゆう液、誘えき、誘掖
ユーエツ	ゆうえつ、優越
ユーカイ	ゆうかい、融解、誘拐
ユーガク	ゆうがく、遊学
ユーキョー	ゆうきょう、遊興
ユーギ	遊戯
ユーギン	遊吟
ユーグー	優遇
ユーゴー	ゆうごう、融合
ユーシ	ゆうし、融資、雄視
ユーシュツ	ゆうしゅつ、ゆう出、涌出、湧出
ユーショー	ゆうしょう、優勝
ユージョ	ゆう恕、宥じょ、宥恕
ユーズー	ゆうずう、ゆう通、融ずう、融通
ユーセイ	ゆうせい、幽せい、幽栖、幽棲
ユーセイガチ	優勢勝ち
ユーセン	ゆうせん、優先、勇戦
ユーゼイ	ゆうぜい、遊説
ユーソー	ゆうそう、郵送
ユータイ	ゆうたい、優待、優退、勇退
ユーターン	ユーターン
ユーダン	勇断
ユーチ	ゆうち、誘致
ユートー	ゆうとう、遊とう、遊蕩
ユードー	ゆうどう、誘導
ユーハツ	誘発
ユーバク	誘爆
ユーヒ	ゆうひ、雄飛
ユーヘイ	ゆうへい、幽閉
ユーホ	ゆうほ、遊歩
ユーボク	ゆうぼく、遊牧
ユーメン	ゆうめん、ゆう免、宥免
ユーモン	ゆうもん、憂もん、憂悶
ユーヤク	ゆうやく、勇躍
ユーヨ	ゆうよ、猶予
ユーヨク	ゆうよく、遊よく、遊弋
ユーラン	ゆうらん、遊覧
ユーリ	ゆうり、遊離
ユーリョ	憂慮
ユーリョー	ゆうりょう、遊猟
ユーレキ	遊歴
ユーワ	ゆうわ、ゆう和、宥和、融和
ユーワク	ゆうわく、誘惑
ヨアソビ	よあそび、夜あそび、夜遊び
ヨウジョー	養じょう
ヨカク	よかく、予覚
ヨカン	よかん、予感
ヨキ	予期
ヨキン	よきん、預金
ヨク	浴
ヨクアツ	よくあつ、抑圧
ヨクサン	よくさん、翼賛
ヨクシ	よくし、抑止
ヨクセイ	よくせい、抑制
ヨクリュー	よくりゅう、抑留
ヨケン	よけん、予見
ヨゲン	よげん、予言、預言
ヨコク	よこく、予告
ヨコズレ	よこずれ、横ずれ
ヨコドリ	よこどり、横取り
ヨコレンボ	横恋慕
ヨサツ	予察
ヨシュー	よしゅう、予習
ヨセガキ	よせがき、寄せ書き、寄書き
ヨセンオチ	予選落ち
ヨソク	よそく、予測
ヨソー	予想
ヨタク	よたく、預託
ヨダン	よだん、予断
ヨチ	予知
ヨッキュー	よっきゅう、よっ求、欲求
ヨテイ	よてい、予定
ヨナオシ	世直し
ヨノー	よのう、予納
ヨバワリ	よばわり、呼ばわり
ヨビステ	よびすて、呼びすて、呼び捨て、呼捨て
ヨビダシ	よびだし、よび出、呼びだし、呼び出、呼び出し、呼出、呼出し
ヨホー	よほう、予報
ヨボー	予防
ヨミカキ	よみかき、読み書き
ヨヤク	よやく、予約
ヨリミチ	よりみち、寄り道
ヨー	擁
ヨーイ	ようい、用意
ヨーイク	よういく、養育
ヨーエイ	ようえい、揺えい、揺曳
ヨーカ	よう化、沃化
ヨーカイ	ようかい、よう解、容かい、容喙、溶解
ヨーキ	ようき、揚棄
ヨーキュー	ようきゅう、要求
ヨーケツ	ようけつ、溶血
ヨーゲキ	よう撃、要撃、邀撃
ヨーゲン	ようげん、揚げん、揚言
ヨーコー	ようこう、洋行
ヨーゴ	ようご、擁護、養護
ヨーシ	よう死、夭死
ヨーシャ	ようしゃ、容赦、用捨
ヨーシュツ	溶出
ヨーショク	ようしょく、養殖
ヨージョー	ようじょう、養生
ヨージン	ようじん、用じん、用心、要じん、要心
ヨースイ	ようすい、揚水
ヨーセイ	ようせい、よう逝、夭逝、要請、養成
ヨーセツ	ようせつ、よう折、よう接、夭折、溶接、熔接
ヨーセン	ようせん、よう船、傭船、用船
ヨーソー	ようそう、洋装
ヨーゾン	溶存
ヨーダン	ようだん、溶断、用談、要談
ヨーチョー	ようちょう、よう懲、膺懲
ヨーテン	ようてん、陽転
ヨーニン	ようにん、容認
ヨーハイ	よう拝、遥拝
ヨーボー	ようぼう、要望
ヨーヤク	要約
ヨーユー	ようゆう、よう融、溶融、熔融
ヨーリツ	擁立
ヨーリャク	要略
ライイン	来院
ライエン	来援、来演
ライオー	来往
ライカイ	来会
ライカン	来観、来館
ライゲキ	雷撃
ライコー	らいこう、来こう、来寇、来校、来航、来貢
ライサン	らいさん、礼さん、礼讚、礼賛
ライシャ	らいしゃ、来社
ライシュー	来襲、来集
ライショ	来所
ライシン	来診
ライジョー	来場
ライタク	来宅
ライダン	来談
ライチャク	来着
ライチョー	らいちょう、来朝、来聴
ライテン	来店
ライトー	来島
ライドー	雷同
ライニチ	来日
ライニン	来任
ライハイ	れい拝、礼はい、礼拝
ライホー	来報、来訪
ライユー	来遊
ラウンド	ラウンド
ラク	らく、楽
ラクインキョ	らくいんきょ、楽隠居
ラクガキ	らくがき、らく書き、ラクガキ、落書、落書き
ラクゴ	らくご、落ご、落伍、落後
ラクサツ	らくさつ、落札
ラクシュ	落手
ラクショク	落飾
ラクショー	らくしょう、楽勝、落掌
ラクジョー	落城
ラクセイ	落成
ラクセキ	落石
ラクセン	落選
ラクタン	落胆
ラクダイ	落第
ラクチャク	落着
ラクハク	らくはく、落はく、落魄
ラクハツ	落髪
ラクバ	落馬
ラクバン	らくばん、落ばん、落盤、落磐
ラクヒツ	落筆
ラクメイ	落命
ラクヨー	落葉
ラクライ	落雷
ラクルイ	落涙
ラシュツ	裸出
ラチ	らち、ら致、拉致
ラッカ	落下
ラッカン	らっかん、らっ観、楽観
ラッキュー	らっきゅう、らっ球、落球
ラッシュ	ラッシュ
ラッセル	ラッセル
ラッチ	らっち、拉致
ラレツ	られつ、羅列
ランカク	らんかく、乱獲、濫獲
ランク	ランク
ランクツ	乱掘、濫掘
ランサク	らん作、乱作、濫作
ランシャ	らんしゃ、乱射
ランシン	らん心、乱心
ランジュク	らんじゅく、らん熟、爛熟
ランスイ	らんすい、乱酔
ランゾー	らんぞう、乱造、濫造
ランダ	らんだ、ランダ、乱だ、乱打
ランデブー	ランデブー
ラントー	らんとう、乱闘
ランドク	らんどく、乱読、濫読
ランニュー	乱入
ランニング	ランニング
ランハンシャ	乱反射
ランバイ	らんばい、乱売
ランバツ	乱伐、濫伐
ランパツ	らんぱつ、乱発、濫発
ランピ	らんぴ、乱ぴ、乱費、濫ぴ、濫費
ランブ	らんぶ、ランブ、乱舞
ランボー	乱暴
ランヨー	らんよう、らん用、乱用、濫用
ランリツ	乱立
リアゲ	りあげ、り上、り上げ、利上、利上げ
リエン	りえん、り縁、離縁
リカイ	りかい、り会、り解、理会、理解
リカク	りかく、り隔、離隔
リカット	リカット
リカバー	リカバー
リカン	りかん、り患、罹患、離間
リキエイ	力泳
リキエン	力演
リキセツ	力説
リキセン	力せん、力戦
リキソー	りきそう、力そう、力漕、力走
リキトー	力とう、力闘
リキョー	りきょう、り京、り郷、離京、離郷
リクエスト	リクエスト
リクコー	陸行
リクセイ	りくせい、陸せい、陸棲、陸生
リクソー	陸送
リクルート	リクルート
リコン	りこん、り婚、離婚
リコー	りこう、り行、履こう、履行
リコール	リコール
リゴー	りごう、り合、離合
リサイ	りさい、り災、罹災
リサイクル	リサイクル
リサゲ	りさげ、り下げ、利下、利下げ
リサン	りさん、り散、離さん、離散
リサーチ	リサーチ
リザーブ	リザーブ
リシュー	りしゅう、り修、履修
リショク	り職、利殖、離職
リショー	りしょう、り床、離床、離礁
リジェクト	リジェクト
リスイ	りすい、り水、離水
リスクヘッジ	リスクヘッジ
リストアップ	リストアップ
リストラ	リストラ
リセキ	りせき、離籍
リセン	りせん、り船、履践、離せん、離船
リソン	りそん、り村、離村
リタイア	リタイア
リダツ	りだつ、り脱、離脱
リチャクリク	り着陸、離着陸
リッキャク	りっきゃく、りっ脚、立脚
リッコー	りっこう、りっ行、力行、陸行
リッコーホ	立候補
リッショク	りっしょく、りっ食、立食
リッショー	りっしょう、りっ証、立証
リッシン	りっしん、りっ身、立身
リッシンシュッセ	立身出世
リップク	りっぷく、りっ腹、立ぷく、立腹
リツアン	立案
リツガン	立がん、立願
リツゲン	立言
リツドー	律動
リツロン	立論
リトー	りとう、り党、り島、離党、離島
リニチ	り日、離日
リニュー	り乳、離乳
リニューアル	リニューアル
リニン	りにん、り任、離任
リノー	りのう、り農、離農
リハッチャク	離発着
リハツ	り髪、理髪
リハン	り反、離反、離叛
リバイバル	リバイバル
リビョー	りびょう、り病、罹病
リファイン	リファイン
リフォーム	リフォーム
リフレッシュ	リフレッシュ
リフレーン	リフレーン
リプライ	リプライ
リプリント	リプリント
リベツ	りべつ、り別、離別
リャクゲン	略言
リャクシュ	略取
リャクショー	略称
リャクジュツ	略述
リャクジョ	略叙
リャクセツ	略説
リャクソー	略そう、略装
リャクダツ	掠奪、略奪
リャクヒツ	略筆
リャッカイ	りゃっかい、りゃっ解、略解
リャッキ	りゃっき、りゃっ記、略記
リューイ	りゅうい、留意
リューカ	りゅうか、流か、流下、硫化
リューカイ	りゅうかい、流会
リューガク	りゅうがく、りゅう学、留学
リューガン	りゅうがん、立願
リューキ	りゅうき、隆き、隆起
リューコー	りゅうこう、流こう、流行
リューザン	りゅうざん、流ざん、流産
リューシツ	流しつ、流失
リューシャク	りゅうしゃく、留しゃく、留錫
リューシュツ	りゅうしゅつ、りゅう出、流しゅつ、流出
リュータイ	りゅうたい、隆替
リューチ	りゅうち、留置
リューツー	りゅうつう、流通
リューテイ	りゅうてい、流てい、流涕
リューデン	りゅうでん、流伝
リュードー	りゅうどう、流動
リューニュー	流入
リューニン	留任
リューネン	留年
リューホ	留保
リューヨー	りゅうよう、流用
リューレン	流れん、流連
リューロ	流露
リョクカ	りょくか、緑か、緑化
リョコー	りょこう、旅行
リョッカ	りょっか、緑化
リョー	諒
リョーカイ	りょうかい、了解、諒解、領会、領解
リョーガ	りょうが、りょう駕、凌駕、陵駕
リョーガエ	両替
リョーケン	りょうけん、了簡、了見、料けん、料簡
リョーサツ	了察、諒察
リョーサン	りょうさん、リョウサン、量さん、量産
リョーシュー	りょうしゅう、領収
リョーショー	了しょう、了承、諒承、領承、領掌
リョージ	りょうじ、リョウジ、療治
リョージョ	りょうじょ、諒じょ、諒恕
リョージョク	りょうじょく、凌辱、陵辱
リョージョー	領掌
リョーダン	両断
リョーチ	りょうち、了知
リョーテイ	りょうてい、量定
リョーハン	量販
リョーブン	両分
リョーユー	領有
リョーヨー	りょうよう、リョウヨウ、両用、療養
リョーリ	りょうり、りょう理、リョウリ、料り、料理
リョーリツ	両立
リヨー	りよう、り用、利用
リライト	リライト
リラクゼーション	リラクゼイション、リラクゼーション
リラックス	リラックス
リリク	りりく、り陸、離陸
リリース	リリース
リリーフ	リリーフ
リレー	リレー
リンカン	りんかん、輪かん、輪姦
リンガ	りんが、臨が、臨画
リンキ	りんき、りん気、悋気
リンギ	りん議、リンギ、稟議
リンク	リンク
リンケン	りんけん、リンケン、臨検
リンコー	りんこう、リンコウ、臨幸、輪講
リンサイ	りんさい、輪栽
リンサク	りん作、輪作
リンシャ	りんしゃ、臨写
リンショ	臨書
リンショー	りんしょう、リンショウ、輪唱
リンジョー	りんじょう、臨場
リンセイ	りんせい、りん請、稟請
リンセキ	臨席
リンセツ	りんせつ、リンセツ、隣接
リンチ	リンチ
リンテン	りんてん、リンテン、輪転
リンドク	輪読
リンネ	りんね、輪ね、輪廻
リンモ	りんも、臨も、臨模
リンラク	りんらく、りん落、淪落
リンリツ	林立
リーク	リーク
リース	リース
リード	リード
ルイカ	るいか、ルイカ、累か、累加
ルイケイ	るいけい、ルイケイ、累計
ルイゲン	累減
ルイサン	るいさん、累算、類さん、類纂
ルイショー	類焼
ルイシン	累進
ルイジ	るいじ、ルイジ、類似
ルイジュー	るいじゅう、類じゅう、類従、類聚
ルイジョー	累乗
ルイスイ	ルイスイ、類推
ルイセキ	累積
ルイゾー	累増
ルイダ	るいだ、塁だ、塁打
ルイヒ	類ひ、類比
ルイベツ	類別
ルゲン	るげん、る言、縷言
ルコク	るこく、る刻、鏤刻
ルコツ	るこつ、る骨、鏤骨
ルジュツ	るじゅつ、る述、屡述、縷述
ルス	る守、留す、留守
ルスバン	るすばん、るす番、留守ばん、留守番
ルセツ	るせつ、る説、流説、縷説
ルチン	縷ちん、縷陳
ルテン	るてん、る転、流転
ルフ	る布、流ふ、流布
ルホー	るほう、る報、屡報
ルロー	るろう、る浪、流浪
レイアウト	レイアウト
レイカ	れいか、霊か、霊化
レイキ	れいき、励起
レイキャク	冷却
レイグー	冷遇、礼遇
レイコー	れいこう、励行
レイショー	例証、冷笑
レイシン	れいしん、励振
レイジ	れいじ、例示、励磁
レイジュー	隷従
レイゾク	隷属
レイゾー	れいぞう、冷ぞう、冷蔵
レイタツ	令達
レイトー	れいとう、冷とう、冷凍
レイニュー	戻入
レイハイ	れい拝、礼はい、礼拝
レイバ	れいば、冷ば、冷罵
レイヒョー	冷評
レイフー	零封
レイプ	レイプ
レイラク	零落
レキサツ	れきさつ、れき殺、轢殺
レキシ	れきし、れき死、轢死
レキダン	れきだん、れき断、轢断
レキニン	歴任
レキホー	歴訪
レキユー	歴遊
レクチャー	レクチャー
レクチュア	レクチュア
レコーディング	レコーディング
レシーブ	レシーブ
レス	レス
レッカ	れっか、劣化
レッカー	レッカー
レッキ	れっき、れっ記、列記
レッキョ	れっきょ、れっ挙、列挙
レッセキ	れっせき、れっ席、列席
レッパイ	れっぱい、劣敗
レツリツ	列立
レビュー	レビュー
レベルアップ	レベルアップ
レポート	レポート
レンアイ	れんあい、恋あい、恋愛
レンカン	れんかん、聯関、連関
レンキ	れんき、連き、連記
レンギン	連吟
レンケイ	れんけい、レンケイ、聯繋、連けい、連係、連携、連繋
レンケツ	れんけつ、連結
レンコ	れんこ、連こ、連呼
レンコー	れんこう、連行
レンゴー	れんごう、聯合、連合
レンサイ	れんさい、連載
レンサク	連作
レンサツ	れんさつ、れん察、憐察
レンザ	連坐、連座
レンシャ	れんしゃ、連射
レンシュ	れんしゅ、連取
レンシュー	れんしゅう、れん習、練習
レンショ	連署
レンショー	れんしょう、連勝
レンジョー	れんじょう、連乗
レンセイ	れんせい、レンセイ、錬成
レンセツ	連接
レンセン	れんせん、連戦
レンソー	れんそう、聯奏、聯想、連奏、連想
レンゾク	れんぞく、連続
レンタイ	れんたい、連帯
レンタツ	練達
レンタル	レンタル
レンダ	れんだ、連だ、連打
レンダク	連濁
レンダン	れんだん、聯弾、連弾
レンチャク	恋着
レントー	れんとう、連騰
レンドー	れんどう、連動
レンバイ	れんばい、廉売
レンバン	連判
レンパ	れんぱ、れん覇、レンパ、連ぱ、連破、連覇
レンパイ	れんぱい、れん敗、連ぱい、連敗
レンパツ	れんぱつ、レンパツ、連ぱつ、連発
レンベイ	連袂
レンボ	れんぼ、恋慕
レンマ	れんま、レンマ、練磨、錬磨
レンヨー	れんよう、連用
レンラク	れんらく、レンラク、聯絡、連らく、連絡
レンリツ	聯立、連立
ロエイ	ろえい、露営
ロカ	ろか、ろ過、濾過
ロカク	ろかく、ろ獲、鹵獲
ロク	録
ロクオン	ろくおん、ろく音、ロクオン、録音
ロクガ	ろくが、ロクガ、録が、録画
ロクガドリ	録画撮り
ログ	ログ
ロケン	ろけん、ろ見、ロケン、露見、露顕
ロコー	ろこう、ろ光、露光
ロシュツ	ろしゅつ、ろ出、露出
ロック	ロック
ロックアウト	ロックアウト
ロテイ	ろてい、露呈
ロンキツ	論詰
ロンキュー	論及、論究
ロンギ	ロンギ、論議
ロンケツ	ろんけつ、論けつ、論決、論結
ロンコク	論告
ロンショー	論証
ロンジュツ	論述
ロンセン	論戦
ロンゼツ	論説
ロンソー	ろんそう、ロンソウ、論争
ロンダン	ろんだん、論断
ロンテイ	論定
ロンナン	論なん、論難
ロンバク	ろんばく、ろん駁、論ばく、論駁
ロンパ	ろんぱ、ろん破、論ぱ、論破
ロンパン	ろんぱん、論ぱん、論判
ロンピョー	ろんぴょう、論ぴょう、論評
ロンベン	論弁
ロー	弄
ローエイ	ろうえい、朗えい、朗詠、漏えい、漏洩
ローカ	ろうか、ロウカ、老か、老化
ローキ	ろうき、ろう記、牢記
ローキョ	ろうきょ、ろう居、篭居、籠居
ローギン	朗吟
ローコク	ろうこく、ろう刻、鏤刻
ローシ	ろうし、ろう死、牢死、老死
ローシュツ	漏出
ローショー	ろうしょう、ろう唱、ろう笑、朗しょう、朗唱、朗笑、朗誦
ロージュク	老熟
ロージョー	ろうじょう、ろう城、篭城、籠城
ロースイ	ろうすい、ろう水、漏水、老衰
ローセイ	ろうせい、老成
ローセツ	漏せつ、漏洩
ローダン	ろうだん、ろう断、壟断、隴断、龍断
ローデン	ろうでん、漏電
ロードク	朗読
ロードー	ろうどう、労働
ローニン	ろうにん、ろう人、ロウニン、浪人
ローハイ	ろうはい、老廃
ローバイ	ろうばい、狼ばい、狼狽
ローヒ	浪費
ローマナイズ	ローマナイズ
ローラク	ろうらく、ろう絡、篭絡、籠絡
ローリング	ローリング
ロール	ロール
ローワ	ろうわ、ろう話、漏話
ワイキョク	わいきょく、わい曲、歪曲
ワイプ	ワイプ
ワカイ	和解
ワカガエリ	わかがえり、若がえり、若返り
ワカジニ	若死、若死に
ワキミ	わきみ、わき見、脇見
ワキョー	わきょう、和協
ワクデキ	わくでき、わく溺、惑でき、惑溺
ワクラン	惑乱
ワゴー	わごう、わ合、和合
ワザワイ	わざわい、災い
ワボク	わぼく、和ぼく、和睦
ワヤク	和訳
ワラク	わらく、わ楽、和らく、和楽
ワリアテ	わりあて、割り当て、割当、割当て
ワリコミ	わりこみ、割りこみ、割り込み、割込、割込み
ワリビキ	わりびき、わり引き、割り引き、割引、割引き
ワンキョク	わんきょく、わん曲、彎曲、湾曲
ワンニュー	彎入、湾入
ワープ	ワープ
